"Brasil e Município";"Situação do domicílio";"Grupo de idade";"Total";"Homens";"Mulheres"
"Brasil";"Total";"Total";"190755799";"93406990";"97348809"
"Alta Floresta D'Oeste (RO)";"Total";"Total";"24392";"12656";"11736"
"Ariquemes (RO)";"Total";"Total";"90353";"45543";"44810"
"Cabixi (RO)";"Total";"Total";"6313";"3266";"3047"
"Cacoal (RO)";"Total";"Total";"78574";"39124";"39450"
"Cerejeiras (RO)";"Total";"Total";"17029";"8551";"8478"
"Colorado do Oeste (RO)";"Total";"Total";"18591";"9330";"9261"
"Corumbiara (RO)";"Total";"Total";"8783";"4711";"4072"
"Costa Marques (RO)";"Total";"Total";"13678";"7202";"6476"
"Espigão D'Oeste (RO)";"Total";"Total";"28729";"14606";"14123"
"Guajará-Mirim (RO)";"Total";"Total";"41656";"20947";"20709"
"Jaru (RO)";"Total";"Total";"52005";"26005";"26000"
"Ji-Paraná (RO)";"Total";"Total";"116610";"57824";"58786"
"Machadinho D'Oeste (RO)";"Total";"Total";"31135";"16536";"14599"
"Nova Brasilândia D'Oeste (RO)";"Total";"Total";"19874";"10344";"9530"
"Ouro Preto do Oeste (RO)";"Total";"Total";"37928";"18698";"19230"
"Pimenta Bueno (RO)";"Total";"Total";"33822";"17041";"16781"
"Porto Velho (RO)";"Total";"Total";"428527";"217618";"210909"
"Presidente Médici (RO)";"Total";"Total";"22319";"11309";"11010"
"Rio Crespo (RO)";"Total";"Total";"3316";"1767";"1549"
"Rolim de Moura (RO)";"Total";"Total";"50648";"25170";"25478"
"Santa Luzia D'Oeste (RO)";"Total";"Total";"8886";"4596";"4290"
"Vilhena (RO)";"Total";"Total";"76202";"37782";"38420"
"São Miguel do Guaporé (RO)";"Total";"Total";"21828";"11328";"10500"
"Nova Mamoré (RO)";"Total";"Total";"22546";"11735";"10811"
"Alvorada D'Oeste (RO)";"Total";"Total";"16853";"8678";"8175"
"Alto Alegre dos Parecis (RO)";"Total";"Total";"12816";"6739";"6077"
"Alto Paraíso (RO)";"Total";"Total";"17135";"9022";"8113"
"Buritis (RO)";"Total";"Total";"32383";"16741";"15642"
"Novo Horizonte do Oeste (RO)";"Total";"Total";"10240";"5336";"4904"
"Cacaulândia (RO)";"Total";"Total";"5736";"2965";"2771"
"Campo Novo de Rondônia (RO)";"Total";"Total";"12665";"6768";"5897"
"Candeias do Jamari (RO)";"Total";"Total";"19779";"10320";"9459"
"Castanheiras (RO)";"Total";"Total";"3575";"1829";"1746"
"Chupinguaia (RO)";"Total";"Total";"8301";"4415";"3886"
"Cujubim (RO)";"Total";"Total";"15854";"8456";"7398"
"Governador Jorge Teixeira (RO)";"Total";"Total";"10512";"5470";"5042"
"Itapuã do Oeste (RO)";"Total";"Total";"8566";"4565";"4001"
"Ministro Andreazza (RO)";"Total";"Total";"10352";"5304";"5048"
"Mirante da Serra (RO)";"Total";"Total";"11878";"6049";"5829"
"Monte Negro (RO)";"Total";"Total";"14091";"7408";"6683"
"Nova União (RO)";"Total";"Total";"7493";"3999";"3494"
"Parecis (RO)";"Total";"Total";"4810";"2595";"2215"
"Pimenteiras do Oeste (RO)";"Total";"Total";"2315";"1218";"1097"
"Primavera de Rondônia (RO)";"Total";"Total";"3524";"1856";"1668"
"São Felipe D'Oeste (RO)";"Total";"Total";"6018";"3086";"2932"
"São Francisco do Guaporé (RO)";"Total";"Total";"16035";"8415";"7620"
"Seringueiras (RO)";"Total";"Total";"11629";"6087";"5542"
"Teixeirópolis (RO)";"Total";"Total";"4888";"2540";"2348"
"Theobroma (RO)";"Total";"Total";"10649";"5653";"4996"
"Urupá (RO)";"Total";"Total";"12974";"6731";"6243"
"Vale do Anari (RO)";"Total";"Total";"9384";"4979";"4405"
"Vale do Paraíso (RO)";"Total";"Total";"8210";"4244";"3966"
"Acrelândia (AC)";"Total";"Total";"12538";"6592";"5946"
"Assis Brasil (AC)";"Total";"Total";"6072";"3091";"2981"
"Brasiléia (AC)";"Total";"Total";"21398";"11037";"10361"
"Bujari (AC)";"Total";"Total";"8471";"4569";"3902"
"Capixaba (AC)";"Total";"Total";"8798";"4655";"4143"
"Cruzeiro do Sul (AC)";"Total";"Total";"78507";"39220";"39287"
"Epitaciolândia (AC)";"Total";"Total";"15100";"7626";"7474"
"Feijó (AC)";"Total";"Total";"32412";"16716";"15696"
"Jordão (AC)";"Total";"Total";"6577";"3412";"3165"
"Mâncio Lima (AC)";"Total";"Total";"15206";"7836";"7370"
"Manoel Urbano (AC)";"Total";"Total";"7981";"4255";"3726"
"Marechal Thaumaturgo (AC)";"Total";"Total";"14227";"7463";"6764"
"Plácido de Castro (AC)";"Total";"Total";"17209";"8999";"8210"
"Porto Walter (AC)";"Total";"Total";"9176";"4794";"4382"
"Rio Branco (AC)";"Total";"Total";"336038";"163592";"172446"
"Rodrigues Alves (AC)";"Total";"Total";"14389";"7479";"6910"
"Santa Rosa do Purus (AC)";"Total";"Total";"4691";"2406";"2285"
"Senador Guiomard (AC)";"Total";"Total";"20179";"10328";"9851"
"Sena Madureira (AC)";"Total";"Total";"38029";"19739";"18290"
"Tarauacá (AC)";"Total";"Total";"35590";"18353";"17237"
"Xapuri (AC)";"Total";"Total";"16091";"8317";"7774"
"Porto Acre (AC)";"Total";"Total";"14880";"7845";"7035"
"Alvarães (AM)";"Total";"Total";"14088";"7416";"6672"
"Amaturá (AM)";"Total";"Total";"9467";"4902";"4565"
"Anamã (AM)";"Total";"Total";"10214";"5446";"4768"
"Anori (AM)";"Total";"Total";"16317";"8511";"7806"
"Apuí (AM)";"Total";"Total";"18007";"9551";"8456"
"Atalaia do Norte (AM)";"Total";"Total";"15153";"7852";"7301"
"Autazes (AM)";"Total";"Total";"32135";"16989";"15146"
"Barcelos (AM)";"Total";"Total";"25718";"13816";"11902"
"Barreirinha (AM)";"Total";"Total";"27355";"14312";"13043"
"Benjamin Constant (AM)";"Total";"Total";"33411";"17260";"16151"
"Beruri (AM)";"Total";"Total";"15486";"8146";"7340"
"Boa Vista do Ramos (AM)";"Total";"Total";"14979";"7945";"7034"
"Boca do Acre (AM)";"Total";"Total";"30632";"15947";"14685"
"Borba (AM)";"Total";"Total";"34961";"18237";"16724"
"Caapiranga (AM)";"Total";"Total";"10975";"5812";"5163"
"Canutama (AM)";"Total";"Total";"12738";"6872";"5866"
"Carauari (AM)";"Total";"Total";"25774";"13259";"12515"
"Careiro (AM)";"Total";"Total";"32734";"16990";"15744"
"Careiro da Várzea (AM)";"Total";"Total";"23930";"12688";"11242"
"Coari (AM)";"Total";"Total";"75965";"39476";"36489"
"Codajás (AM)";"Total";"Total";"23206";"12107";"11099"
"Eirunepé (AM)";"Total";"Total";"30665";"15779";"14886"
"Envira (AM)";"Total";"Total";"16338";"8392";"7946"
"Fonte Boa (AM)";"Total";"Total";"22817";"11824";"10993"
"Guajará (AM)";"Total";"Total";"13974";"7265";"6709"
"Humaitá (AM)";"Total";"Total";"44227";"23204";"21023"
"Ipixuna (AM)";"Total";"Total";"22254";"11355";"10899"
"Iranduba (AM)";"Total";"Total";"40781";"20996";"19785"
"Itacoatiara (AM)";"Total";"Total";"86839";"44426";"42413"
"Itamarati (AM)";"Total";"Total";"8038";"4236";"3802"
"Itapiranga (AM)";"Total";"Total";"8211";"4299";"3912"
"Japurá (AM)";"Total";"Total";"7326";"3835";"3491"
"Juruá (AM)";"Total";"Total";"10802";"5548";"5254"
"Jutaí (AM)";"Total";"Total";"17992";"9432";"8560"
"Lábrea (AM)";"Total";"Total";"37701";"19638";"18063"
"Manacapuru (AM)";"Total";"Total";"85141";"43461";"41680"
"Manaquiri (AM)";"Total";"Total";"22801";"11744";"11057"
"Manaus (AM)";"Total";"Total";"1802014";"879742";"922272"
"Manicoré (AM)";"Total";"Total";"47017";"24684";"22333"
"Maraã (AM)";"Total";"Total";"17528";"9407";"8121"
"Maués (AM)";"Total";"Total";"52236";"27283";"24953"
"Nhamundá (AM)";"Total";"Total";"18278";"9496";"8782"
"Nova Olinda do Norte (AM)";"Total";"Total";"30696";"15748";"14948"
"Novo Airão (AM)";"Total";"Total";"14723";"7607";"7116"
"Novo Aripuanã (AM)";"Total";"Total";"21451";"11429";"10022"
"Parintins (AM)";"Total";"Total";"102033";"52304";"49729"
"Pauini (AM)";"Total";"Total";"18166";"9490";"8676"
"Presidente Figueiredo (AM)";"Total";"Total";"27175";"14350";"12825"
"Rio Preto da Eva (AM)";"Total";"Total";"25719";"13406";"12313"
"Santa Isabel do Rio Negro (AM)";"Total";"Total";"18146";"9322";"8824"
"Santo Antônio do Içá (AM)";"Total";"Total";"24481";"12592";"11889"
"São Gabriel da Cachoeira (AM)";"Total";"Total";"37896";"19463";"18433"
"São Paulo de Olivença (AM)";"Total";"Total";"31422";"16266";"15156"
"São Sebastião do Uatumã (AM)";"Total";"Total";"10705";"5680";"5025"
"Silves (AM)";"Total";"Total";"8444";"4498";"3946"
"Tabatinga (AM)";"Total";"Total";"52272";"26359";"25913"
"Tapauá (AM)";"Total";"Total";"19077";"10075";"9002"
"Tefé (AM)";"Total";"Total";"61453";"31518";"29935"
"Tonantins (AM)";"Total";"Total";"17079";"8777";"8302"
"Uarini (AM)";"Total";"Total";"11891";"6332";"5559"
"Urucará (AM)";"Total";"Total";"17094";"8854";"8240"
"Urucurituba (AM)";"Total";"Total";"17837";"9529";"8308"
"Amajari (RR)";"Total";"Total";"9327";"4992";"4335"
"Alto Alegre (RR)";"Total";"Total";"16448";"8676";"7772"
"Boa Vista (RR)";"Total";"Total";"284313";"140801";"143512"
"Bonfim (RR)";"Total";"Total";"10943";"5879";"5064"
"Cantá (RR)";"Total";"Total";"13902";"7538";"6364"
"Caracaraí (RR)";"Total";"Total";"18398";"9732";"8666"
"Caroebe (RR)";"Total";"Total";"8114";"4309";"3805"
"Iracema (RR)";"Total";"Total";"8696";"4600";"4096"
"Mucajaí (RR)";"Total";"Total";"14792";"7865";"6927"
"Normandia (RR)";"Total";"Total";"8940";"4678";"4262"
"Pacaraima (RR)";"Total";"Total";"10433";"5408";"5025"
"Rorainópolis (RR)";"Total";"Total";"24279";"12923";"11356"
"São João da Baliza (RR)";"Total";"Total";"6769";"3551";"3218"
"São Luiz (RR)";"Total";"Total";"6750";"3568";"3182"
"Uiramutã (RR)";"Total";"Total";"8375";"4339";"4036"
"Abaetetuba (PA)";"Total";"Total";"141100";"71630";"69470"
"Abel Figueiredo (PA)";"Total";"Total";"6780";"3533";"3247"
"Acará (PA)";"Total";"Total";"53569";"28115";"25454"
"Afuá (PA)";"Total";"Total";"35042";"18453";"16589"
"Água Azul do Norte (PA)";"Total";"Total";"25057";"13618";"11439"
"Alenquer (PA)";"Total";"Total";"52626";"27030";"25596"
"Almeirim (PA)";"Total";"Total";"33614";"17468";"16146"
"Altamira (PA)";"Total";"Total";"99075";"49819";"49256"
"Anajás (PA)";"Total";"Total";"24759";"12957";"11802"
"Ananindeua (PA)";"Total";"Total";"471980";"226635";"245345"
"Anapu (PA)";"Total";"Total";"20543";"10992";"9551"
"Augusto Corrêa (PA)";"Total";"Total";"40497";"20989";"19508"
"Aurora do Pará (PA)";"Total";"Total";"26546";"13620";"12926"
"Aveiro (PA)";"Total";"Total";"15849";"8367";"7482"
"Bagre (PA)";"Total";"Total";"23864";"12135";"11729"
"Baião (PA)";"Total";"Total";"36882";"19446";"17436"
"Bannach (PA)";"Total";"Total";"3431";"1847";"1584"
"Barcarena (PA)";"Total";"Total";"99859";"50346";"49513"
"Belém (PA)";"Total";"Total";"1393399";"659008";"734391"
"Belterra (PA)";"Total";"Total";"16318";"8481";"7837"
"Benevides (PA)";"Total";"Total";"51651";"25815";"25836"
"Bom Jesus do Tocantins (PA)";"Total";"Total";"15298";"8051";"7247"
"Bonito (PA)";"Total";"Total";"13630";"7114";"6516"
"Bragança (PA)";"Total";"Total";"113227";"57291";"55936"
"Brasil Novo (PA)";"Total";"Total";"15690";"8314";"7376"
"Brejo Grande do Araguaia (PA)";"Total";"Total";"7317";"3832";"3485"
"Breu Branco (PA)";"Total";"Total";"52493";"27085";"25408"
"Breves (PA)";"Total";"Total";"92860";"47788";"45072"
"Bujaru (PA)";"Total";"Total";"25695";"13335";"12360"
"Cachoeira do Piriá (PA)";"Total";"Total";"26484";"13720";"12764"
"Cachoeira do Arari (PA)";"Total";"Total";"20443";"10545";"9898"
"Cametá (PA)";"Total";"Total";"120896";"62016";"58880"
"Canaã dos Carajás (PA)";"Total";"Total";"26716";"13585";"13131"
"Capanema (PA)";"Total";"Total";"63639";"31494";"32145"
"Capitão Poço (PA)";"Total";"Total";"51893";"26621";"25272"
"Castanhal (PA)";"Total";"Total";"173149";"84476";"88673"
"Chaves (PA)";"Total";"Total";"21005";"11180";"9825"
"Colares (PA)";"Total";"Total";"11381";"5879";"5502"
"Conceição do Araguaia (PA)";"Total";"Total";"45557";"23309";"22248"
"Concórdia do Pará (PA)";"Total";"Total";"28216";"14590";"13626"
"Cumaru do Norte (PA)";"Total";"Total";"10466";"6081";"4385"
"Curionópolis (PA)";"Total";"Total";"18288";"9666";"8622"
"Curralinho (PA)";"Total";"Total";"28549";"15059";"13490"
"Curuá (PA)";"Total";"Total";"12254";"6456";"5798"
"Curuçá (PA)";"Total";"Total";"34294";"17568";"16726"
"Dom Eliseu (PA)";"Total";"Total";"51319";"26624";"24695"
"Eldorado do Carajás (PA)";"Total";"Total";"31786";"16814";"14972"
"Faro (PA)";"Total";"Total";"8177";"4240";"3937"
"Floresta do Araguaia (PA)";"Total";"Total";"17768";"9551";"8217"
"Garrafão do Norte (PA)";"Total";"Total";"25034";"13107";"11927"
"Goianésia do Pará (PA)";"Total";"Total";"30436";"15750";"14686"
"Gurupá (PA)";"Total";"Total";"29062";"15400";"13662"
"Igarapé-Açu (PA)";"Total";"Total";"35887";"18117";"17770"
"Igarapé-Miri (PA)";"Total";"Total";"58077";"29674";"28403"
"Inhangapi (PA)";"Total";"Total";"10037";"5170";"4867"
"Ipixuna do Pará (PA)";"Total";"Total";"51309";"26904";"24405"
"Irituia (PA)";"Total";"Total";"31364";"16261";"15103"
"Itaituba (PA)";"Total";"Total";"97493";"49681";"47812"
"Itupiranga (PA)";"Total";"Total";"51220";"27026";"24194"
"Jacareacanga (PA)";"Total";"Total";"14103";"8037";"6066"
"Jacundá (PA)";"Total";"Total";"51360";"25769";"25591"
"Juruti (PA)";"Total";"Total";"47086";"24578";"22508"
"Limoeiro do Ajuru (PA)";"Total";"Total";"25021";"13115";"11906"
"Mãe do Rio (PA)";"Total";"Total";"27904";"13740";"14164"
"Magalhães Barata (PA)";"Total";"Total";"8115";"4258";"3857"
"Marabá (PA)";"Total";"Total";"233669";"118196";"115473"
"Maracanã (PA)";"Total";"Total";"28376";"14699";"13677"
"Marapanim (PA)";"Total";"Total";"26605";"13884";"12721"
"Marituba (PA)";"Total";"Total";"108246";"53884";"54362"
"Medicilândia (PA)";"Total";"Total";"27328";"14888";"12440"
"Melgaço (PA)";"Total";"Total";"24808";"13227";"11581"
"Mocajuba (PA)";"Total";"Total";"26731";"13747";"12984"
"Moju (PA)";"Total";"Total";"70018";"36666";"33352"
"Monte Alegre (PA)";"Total";"Total";"55462";"28508";"26954"
"Muaná (PA)";"Total";"Total";"34204";"17906";"16298"
"Nova Esperança do Piriá (PA)";"Total";"Total";"20158";"10643";"9515"
"Nova Ipixuna (PA)";"Total";"Total";"14645";"7731";"6914"
"Nova Timboteua (PA)";"Total";"Total";"13670";"7082";"6588"
"Novo Progresso (PA)";"Total";"Total";"25124";"13435";"11689"
"Novo Repartimento (PA)";"Total";"Total";"62050";"32748";"29302"
"Óbidos (PA)";"Total";"Total";"49333";"25563";"23770"
"Oeiras do Pará (PA)";"Total";"Total";"28595";"15017";"13578"
"Oriximiná (PA)";"Total";"Total";"62794";"31756";"31038"
"Ourém (PA)";"Total";"Total";"16311";"8443";"7868"
"Ourilândia do Norte (PA)";"Total";"Total";"27359";"14270";"13089"
"Pacajá (PA)";"Total";"Total";"39979";"21599";"18380"
"Palestina do Pará (PA)";"Total";"Total";"7475";"3879";"3596"
"Paragominas (PA)";"Total";"Total";"97819";"49267";"48552"
"Parauapebas (PA)";"Total";"Total";"153908";"77893";"76015"
"Pau D'Arco (PA)";"Total";"Total";"6033";"3178";"2855"
"Peixe-Boi (PA)";"Total";"Total";"7854";"4039";"3815"
"Piçarra (PA)";"Total";"Total";"12697";"6776";"5921"
"Placas (PA)";"Total";"Total";"23934";"12568";"11366"
"Ponta de Pedras (PA)";"Total";"Total";"25999";"13379";"12620"
"Portel (PA)";"Total";"Total";"52172";"26818";"25354"
"Porto de Moz (PA)";"Total";"Total";"33956";"17612";"16344"
"Prainha (PA)";"Total";"Total";"29349";"15516";"13833"
"Primavera (PA)";"Total";"Total";"10268";"5300";"4968"
"Quatipuru (PA)";"Total";"Total";"12411";"6461";"5950"
"Redenção (PA)";"Total";"Total";"75556";"38016";"37540"
"Rio Maria (PA)";"Total";"Total";"17697";"9161";"8536"
"Rondon do Pará (PA)";"Total";"Total";"46964";"24274";"22690"
"Rurópolis (PA)";"Total";"Total";"40087";"20875";"19212"
"Salinópolis (PA)";"Total";"Total";"37421";"19096";"18325"
"Salvaterra (PA)";"Total";"Total";"20183";"10292";"9891"
"Santa Bárbara do Pará (PA)";"Total";"Total";"17141";"8755";"8386"
"Santa Cruz do Arari (PA)";"Total";"Total";"8155";"4142";"4013"
"Santa Izabel do Pará (PA)";"Total";"Total";"59466";"31156";"28310"
"Santa Luzia do Pará (PA)";"Total";"Total";"19424";"9884";"9540"
"Santa Maria das Barreiras (PA)";"Total";"Total";"17206";"9497";"7709"
"Santa Maria do Pará (PA)";"Total";"Total";"23026";"11492";"11534"
"Santana do Araguaia (PA)";"Total";"Total";"56153";"29788";"26365"
"Santarém (PA)";"Total";"Total";"294580";"145533";"149047"
"Santarém Novo (PA)";"Total";"Total";"6141";"3211";"2930"
"Santo Antônio do Tauá (PA)";"Total";"Total";"26674";"13433";"13241"
"São Caetano de Odivelas (PA)";"Total";"Total";"16891";"8806";"8085"
"São Domingos do Araguaia (PA)";"Total";"Total";"23130";"11901";"11229"
"São Domingos do Capim (PA)";"Total";"Total";"29846";"15741";"14105"
"São Félix do Xingu (PA)";"Total";"Total";"91340";"48691";"42649"
"São Francisco do Pará (PA)";"Total";"Total";"15060";"7775";"7285"
"São Geraldo do Araguaia (PA)";"Total";"Total";"25587";"13093";"12494"
"São João da Ponta (PA)";"Total";"Total";"5265";"2738";"2527"
"São João de Pirabas (PA)";"Total";"Total";"20647";"10760";"9887"
"São João do Araguaia (PA)";"Total";"Total";"13155";"7149";"6006"
"São Miguel do Guamá (PA)";"Total";"Total";"51567";"26028";"25539"
"São Sebastião da Boa Vista (PA)";"Total";"Total";"22904";"11833";"11071"
"Sapucaia (PA)";"Total";"Total";"5047";"2710";"2337"
"Senador José Porfírio (PA)";"Total";"Total";"13045";"6995";"6050"
"Soure (PA)";"Total";"Total";"23001";"11472";"11529"
"Tailândia (PA)";"Total";"Total";"79297";"40991";"38306"
"Terra Alta (PA)";"Total";"Total";"10262";"5272";"4990"
"Terra Santa (PA)";"Total";"Total";"16949";"8776";"8173"
"Tomé-Açu (PA)";"Total";"Total";"56518";"29323";"27195"
"Tracuateua (PA)";"Total";"Total";"27455";"14328";"13127"
"Trairão (PA)";"Total";"Total";"16875";"9146";"7729"
"Tucumã (PA)";"Total";"Total";"33690";"17489";"16201"
"Tucuruí (PA)";"Total";"Total";"97128";"48402";"48726"
"Ulianópolis (PA)";"Total";"Total";"43341";"22209";"21132"
"Uruará (PA)";"Total";"Total";"44789";"23633";"21156"
"Vigia (PA)";"Total";"Total";"47889";"24548";"23341"
"Viseu (PA)";"Total";"Total";"56716";"29817";"26899"
"Vitória do Xingu (PA)";"Total";"Total";"13431";"7281";"6150"
"Xinguara (PA)";"Total";"Total";"40573";"20572";"20001"
"Serra do Navio (AP)";"Total";"Total";"4380";"2333";"2047"
"Amapá (AP)";"Total";"Total";"8069";"4211";"3858"
"Pedra Branca do Amapari (AP)";"Total";"Total";"10772";"5866";"4906"
"Calçoene (AP)";"Total";"Total";"9000";"4821";"4179"
"Cutias (AP)";"Total";"Total";"4696";"2424";"2272"
"Ferreira Gomes (AP)";"Total";"Total";"5802";"3046";"2756"
"Itaubal (AP)";"Total";"Total";"4265";"2320";"1945"
"Laranjal do Jari (AP)";"Total";"Total";"39942";"20434";"19508"
"Macapá (AP)";"Total";"Total";"398204";"195613";"202591"
"Mazagão (AP)";"Total";"Total";"17032";"8974";"8058"
"Oiapoque (AP)";"Total";"Total";"20509";"10704";"9805"
"Porto Grande (AP)";"Total";"Total";"16809";"8872";"7937"
"Pracuúba (AP)";"Total";"Total";"3793";"1997";"1796"
"Santana (AP)";"Total";"Total";"101262";"50414";"50848"
"Tartarugalzinho (AP)";"Total";"Total";"12563";"6679";"5884"
"Vitória do Jari (AP)";"Total";"Total";"12428";"6427";"6001"
"Abreulândia (TO)";"Total";"Total";"2391";"1261";"1130"
"Aguiarnópolis (TO)";"Total";"Total";"5162";"2618";"2544"
"Aliança do Tocantins (TO)";"Total";"Total";"5671";"2907";"2764"
"Almas (TO)";"Total";"Total";"7586";"3965";"3621"
"Alvorada (TO)";"Total";"Total";"8374";"4252";"4122"
"Ananás (TO)";"Total";"Total";"9865";"4981";"4884"
"Angico (TO)";"Total";"Total";"3175";"1673";"1502"
"Aparecida do Rio Negro (TO)";"Total";"Total";"4213";"2170";"2043"
"Aragominas (TO)";"Total";"Total";"5882";"3138";"2744"
"Araguacema (TO)";"Total";"Total";"6317";"3331";"2986"
"Araguaçu (TO)";"Total";"Total";"8786";"4511";"4275"
"Araguaína (TO)";"Total";"Total";"150484";"73587";"76897"
"Araguanã (TO)";"Total";"Total";"5030";"2584";"2446"
"Araguatins (TO)";"Total";"Total";"31329";"15968";"15361"
"Arapoema (TO)";"Total";"Total";"6742";"3447";"3295"
"Arraias (TO)";"Total";"Total";"10645";"5393";"5252"
"Augustinópolis (TO)";"Total";"Total";"15950";"8005";"7945"
"Aurora do Tocantins (TO)";"Total";"Total";"3446";"1774";"1672"
"Axixá do Tocantins (TO)";"Total";"Total";"9275";"4600";"4675"
"Babaçulândia (TO)";"Total";"Total";"10424";"5540";"4884"
"Bandeirantes do Tocantins (TO)";"Total";"Total";"3122";"1692";"1430"
"Barra do Ouro (TO)";"Total";"Total";"4123";"2195";"1928"
"Barrolândia (TO)";"Total";"Total";"5349";"2758";"2591"
"Bernardo Sayão (TO)";"Total";"Total";"4456";"2325";"2131"
"Bom Jesus do Tocantins (TO)";"Total";"Total";"3768";"1989";"1779"
"Brasilândia do Tocantins (TO)";"Total";"Total";"2064";"1057";"1007"
"Brejinho de Nazaré (TO)";"Total";"Total";"5185";"2599";"2586"
"Buriti do Tocantins (TO)";"Total";"Total";"9768";"4939";"4829"
"Cachoeirinha (TO)";"Total";"Total";"2148";"1137";"1011"
"Campos Lindos (TO)";"Total";"Total";"8139";"4264";"3875"
"Cariri do Tocantins (TO)";"Total";"Total";"3756";"2106";"1650"
"Carmolândia (TO)";"Total";"Total";"2316";"1206";"1110"
"Carrasco Bonito (TO)";"Total";"Total";"3688";"1919";"1769"
"Caseara (TO)";"Total";"Total";"4601";"2384";"2217"
"Centenário (TO)";"Total";"Total";"2566";"1375";"1191"
"Chapada de Areia (TO)";"Total";"Total";"1335";"716";"619"
"Chapada da Natividade (TO)";"Total";"Total";"3277";"1792";"1485"
"Colinas do Tocantins (TO)";"Total";"Total";"30838";"15288";"15550"
"Combinado (TO)";"Total";"Total";"4669";"2374";"2295"
"Conceição do Tocantins (TO)";"Total";"Total";"4182";"2132";"2050"
"Couto Magalhães (TO)";"Total";"Total";"5009";"2638";"2371"
"Cristalândia (TO)";"Total";"Total";"7234";"3699";"3535"
"Crixás do Tocantins (TO)";"Total";"Total";"1564";"821";"743"
"Darcinópolis (TO)";"Total";"Total";"5273";"2775";"2498"
"Dianópolis (TO)";"Total";"Total";"19112";"9679";"9433"
"Divinópolis do Tocantins (TO)";"Total";"Total";"6363";"3280";"3083"
"Dois Irmãos do Tocantins (TO)";"Total";"Total";"7161";"3958";"3203"
"Dueré (TO)";"Total";"Total";"4592";"2440";"2152"
"Esperantina (TO)";"Total";"Total";"9476";"4910";"4566"
"Fátima (TO)";"Total";"Total";"3805";"1909";"1896"
"Figueirópolis (TO)";"Total";"Total";"5340";"2705";"2635"
"Filadélfia (TO)";"Total";"Total";"8505";"4470";"4035"
"Formoso do Araguaia (TO)";"Total";"Total";"18427";"9607";"8820"
"Fortaleza do Tabocão (TO)";"Total";"Total";"2419";"1234";"1185"
"Goianorte (TO)";"Total";"Total";"4956";"2649";"2307"
"Goiatins (TO)";"Total";"Total";"12064";"6287";"5777"
"Guaraí (TO)";"Total";"Total";"23200";"11687";"11513"
"Gurupi (TO)";"Total";"Total";"76755";"38107";"38648"
"Ipueiras (TO)";"Total";"Total";"1639";"864";"775"
"Itacajá (TO)";"Total";"Total";"7104";"3731";"3373"
"Itaguatins (TO)";"Total";"Total";"6029";"3104";"2925"
"Itapiratins (TO)";"Total";"Total";"3532";"1913";"1619"
"Itaporã do Tocantins (TO)";"Total";"Total";"2445";"1285";"1160"
"Jaú do Tocantins (TO)";"Total";"Total";"3507";"1815";"1692"
"Juarina (TO)";"Total";"Total";"2231";"1176";"1055"
"Lagoa da Confusão (TO)";"Total";"Total";"10210";"5525";"4685"
"Lagoa do Tocantins (TO)";"Total";"Total";"3525";"1830";"1695"
"Lajeado (TO)";"Total";"Total";"2773";"1464";"1309"
"Lavandeira (TO)";"Total";"Total";"1605";"838";"767"
"Lizarda (TO)";"Total";"Total";"3725";"2007";"1718"
"Luzinópolis (TO)";"Total";"Total";"2622";"1350";"1272"
"Marianópolis do Tocantins (TO)";"Total";"Total";"4352";"2318";"2034"
"Mateiros (TO)";"Total";"Total";"2223";"1187";"1036"
"Maurilândia do Tocantins (TO)";"Total";"Total";"3154";"1697";"1457"
"Miracema do Tocantins (TO)";"Total";"Total";"20684";"10347";"10337"
"Miranorte (TO)";"Total";"Total";"12623";"6423";"6200"
"Monte do Carmo (TO)";"Total";"Total";"6716";"3601";"3115"
"Monte Santo do Tocantins (TO)";"Total";"Total";"2085";"1120";"965"
"Palmeiras do Tocantins (TO)";"Total";"Total";"5740";"2991";"2749"
"Muricilândia (TO)";"Total";"Total";"3152";"1657";"1495"
"Natividade (TO)";"Total";"Total";"9000";"4596";"4404"
"Nazaré (TO)";"Total";"Total";"4386";"2262";"2124"
"Nova Olinda (TO)";"Total";"Total";"10686";"5576";"5110"
"Nova Rosalândia (TO)";"Total";"Total";"3770";"1965";"1805"
"Novo Acordo (TO)";"Total";"Total";"3762";"1921";"1841"
"Novo Alegre (TO)";"Total";"Total";"2286";"1180";"1106"
"Novo Jardim (TO)";"Total";"Total";"2457";"1277";"1180"
"Oliveira de Fátima (TO)";"Total";"Total";"1037";"552";"485"
"Palmeirante (TO)";"Total";"Total";"4954";"2659";"2295"
"Palmeirópolis (TO)";"Total";"Total";"7339";"3704";"3635"
"Paraíso do Tocantins (TO)";"Total";"Total";"44417";"22113";"22304"
"Paranã (TO)";"Total";"Total";"10338";"5444";"4894"
"Pau D'Arco (TO)";"Total";"Total";"4588";"2459";"2129"
"Pedro Afonso (TO)";"Total";"Total";"11539";"5969";"5570"
"Peixe (TO)";"Total";"Total";"10384";"5427";"4957"
"Pequizeiro (TO)";"Total";"Total";"5054";"2667";"2387"
"Colméia (TO)";"Total";"Total";"8611";"4368";"4243"
"Pindorama do Tocantins (TO)";"Total";"Total";"4506";"2385";"2121"
"Piraquê (TO)";"Total";"Total";"2920";"1626";"1294"
"Pium (TO)";"Total";"Total";"6694";"3526";"3168"
"Ponte Alta do Bom Jesus (TO)";"Total";"Total";"4544";"2405";"2139"
"Ponte Alta do Tocantins (TO)";"Total";"Total";"7180";"3879";"3301"
"Porto Alegre do Tocantins (TO)";"Total";"Total";"2796";"1431";"1365"
"Porto Nacional (TO)";"Total";"Total";"49146";"24517";"24629"
"Praia Norte (TO)";"Total";"Total";"7659";"3897";"3762"
"Presidente Kennedy (TO)";"Total";"Total";"3681";"1882";"1799"
"Pugmil (TO)";"Total";"Total";"2369";"1257";"1112"
"Recursolândia (TO)";"Total";"Total";"3768";"2008";"1760"
"Riachinho (TO)";"Total";"Total";"4191";"2168";"2023"
"Rio da Conceição (TO)";"Total";"Total";"1714";"886";"828"
"Rio dos Bois (TO)";"Total";"Total";"2570";"1361";"1209"
"Rio Sono (TO)";"Total";"Total";"6254";"3379";"2875"
"Sampaio (TO)";"Total";"Total";"3864";"1970";"1894"
"Sandolândia (TO)";"Total";"Total";"3326";"1741";"1585"
"Santa Fé do Araguaia (TO)";"Total";"Total";"6599";"3417";"3182"
"Santa Maria do Tocantins (TO)";"Total";"Total";"2894";"1518";"1376"
"Santa Rita do Tocantins (TO)";"Total";"Total";"2128";"1109";"1019"
"Santa Rosa do Tocantins (TO)";"Total";"Total";"4568";"2411";"2157"
"Santa Tereza do Tocantins (TO)";"Total";"Total";"2523";"1339";"1184"
"Santa Terezinha do Tocantins (TO)";"Total";"Total";"2474";"1268";"1206"
"São Bento do Tocantins (TO)";"Total";"Total";"4608";"2403";"2205"
"São Félix do Tocantins (TO)";"Total";"Total";"1437";"770";"667"
"São Miguel do Tocantins (TO)";"Total";"Total";"10481";"5290";"5191"
"São Salvador do Tocantins (TO)";"Total";"Total";"2910";"1486";"1424"
"São Sebastião do Tocantins (TO)";"Total";"Total";"4283";"2199";"2084"
"São Valério (TO)";"Total";"Total";"4383";"2267";"2116"
"Silvanópolis (TO)";"Total";"Total";"5068";"2655";"2413"
"Sítio Novo do Tocantins (TO)";"Total";"Total";"9148";"4631";"4517"
"Sucupira (TO)";"Total";"Total";"1742";"894";"848"
"Taguatinga (TO)";"Total";"Total";"15051";"7884";"7167"
"Taipas do Tocantins (TO)";"Total";"Total";"1945";"1017";"928"
"Talismã (TO)";"Total";"Total";"2562";"1351";"1211"
"Palmas (TO)";"Total";"Total";"228332";"112848";"115484"
"Tocantínia (TO)";"Total";"Total";"6736";"3476";"3260"
"Tocantinópolis (TO)";"Total";"Total";"22619";"11200";"11419"
"Tupirama (TO)";"Total";"Total";"1574";"843";"731"
"Tupiratins (TO)";"Total";"Total";"2097";"1087";"1010"
"Wanderlândia (TO)";"Total";"Total";"10981";"5647";"5334"
"Xambioá (TO)";"Total";"Total";"11484";"5907";"5577"
"Açailândia (MA)";"Total";"Total";"104047";"52115";"51932"
"Afonso Cunha (MA)";"Total";"Total";"5905";"2972";"2933"
"Água Doce do Maranhão (MA)";"Total";"Total";"11581";"6018";"5563"
"Alcântara (MA)";"Total";"Total";"21851";"11258";"10593"
"Aldeias Altas (MA)";"Total";"Total";"23952";"12395";"11557"
"Altamira do Maranhão (MA)";"Total";"Total";"11063";"5567";"5496"
"Alto Alegre do Maranhão (MA)";"Total";"Total";"24599";"12274";"12325"
"Alto Alegre do Pindaré (MA)";"Total";"Total";"31057";"16022";"15035"
"Alto Parnaíba (MA)";"Total";"Total";"10766";"5468";"5298"
"Amapá do Maranhão (MA)";"Total";"Total";"6431";"3312";"3119"
"Amarante do Maranhão (MA)";"Total";"Total";"37932";"19782";"18150"
"Anajatuba (MA)";"Total";"Total";"25291";"12959";"12332"
"Anapurus (MA)";"Total";"Total";"13939";"7020";"6919"
"Apicum-Açu (MA)";"Total";"Total";"14959";"7816";"7143"
"Araguanã (MA)";"Total";"Total";"13973";"7119";"6854"
"Araioses (MA)";"Total";"Total";"42505";"22007";"20498"
"Arame (MA)";"Total";"Total";"31702";"16483";"15219"
"Arari (MA)";"Total";"Total";"28488";"14315";"14173"
"Axixá (MA)";"Total";"Total";"11407";"5822";"5585"
"Bacabal (MA)";"Total";"Total";"100014";"47757";"52257"
"Bacabeira (MA)";"Total";"Total";"14925";"7510";"7415"
"Bacuri (MA)";"Total";"Total";"16604";"8487";"8117"
"Bacurituba (MA)";"Total";"Total";"5293";"2745";"2548"
"Balsas (MA)";"Total";"Total";"83528";"41574";"41954"
"Barão de Grajaú (MA)";"Total";"Total";"17841";"8937";"8904"
"Barra do Corda (MA)";"Total";"Total";"82830";"41656";"41174"
"Barreirinhas (MA)";"Total";"Total";"54930";"28132";"26798"
"Belágua (MA)";"Total";"Total";"6524";"3423";"3101"
"Bela Vista do Maranhão (MA)";"Total";"Total";"12049";"6109";"5940"
"Benedito Leite (MA)";"Total";"Total";"5469";"2855";"2614"
"Bequimão (MA)";"Total";"Total";"20344";"10349";"9995"
"Bernardo do Mearim (MA)";"Total";"Total";"5996";"2973";"3023"
"Boa Vista do Gurupi (MA)";"Total";"Total";"7949";"4041";"3908"
"Bom Jardim (MA)";"Total";"Total";"39049";"19850";"19199"
"Bom Jesus das Selvas (MA)";"Total";"Total";"28459";"14872";"13587"
"Bom Lugar (MA)";"Total";"Total";"14818";"7553";"7265"
"Brejo (MA)";"Total";"Total";"33359";"16883";"16476"
"Brejo de Areia (MA)";"Total";"Total";"5577";"2867";"2710"
"Buriti (MA)";"Total";"Total";"27013";"13678";"13335"
"Buriti Bravo (MA)";"Total";"Total";"22899";"11325";"11574"
"Buriticupu (MA)";"Total";"Total";"65237";"33316";"31921"
"Buritirana (MA)";"Total";"Total";"14784";"7536";"7248"
"Cachoeira Grande (MA)";"Total";"Total";"8446";"4403";"4043"
"Cajapió (MA)";"Total";"Total";"10593";"5365";"5228"
"Cajari (MA)";"Total";"Total";"18338";"9509";"8829"
"Campestre do Maranhão (MA)";"Total";"Total";"13369";"6819";"6550"
"Cândido Mendes (MA)";"Total";"Total";"18505";"9690";"8815"
"Cantanhede (MA)";"Total";"Total";"20448";"10254";"10194"
"Capinzal do Norte (MA)";"Total";"Total";"10698";"5345";"5353"
"Carolina (MA)";"Total";"Total";"23959";"12285";"11674"
"Carutapera (MA)";"Total";"Total";"22006";"11338";"10668"
"Caxias (MA)";"Total";"Total";"155129";"75082";"80047"
"Cedral (MA)";"Total";"Total";"10297";"5395";"4902"
"Central do Maranhão (MA)";"Total";"Total";"7887";"4087";"3800"
"Centro do Guilherme (MA)";"Total";"Total";"12565";"6641";"5924"
"Centro Novo do Maranhão (MA)";"Total";"Total";"17622";"9331";"8291"
"Chapadinha (MA)";"Total";"Total";"73350";"36243";"37107"
"Cidelândia (MA)";"Total";"Total";"13681";"7011";"6670"
"Codó (MA)";"Total";"Total";"118038";"57403";"60635"
"Coelho Neto (MA)";"Total";"Total";"46750";"23002";"23748"
"Colinas (MA)";"Total";"Total";"39132";"19395";"19737"
"Conceição do Lago-Açu (MA)";"Total";"Total";"14436";"7481";"6955"
"Coroatá (MA)";"Total";"Total";"61725";"30662";"31063"
"Cururupu (MA)";"Total";"Total";"32652";"16599";"16053"
"Davinópolis (MA)";"Total";"Total";"12579";"6271";"6308"
"Dom Pedro (MA)";"Total";"Total";"22681";"10950";"11731"
"Duque Bacelar (MA)";"Total";"Total";"10649";"5383";"5266"
"Esperantinópolis (MA)";"Total";"Total";"18452";"9075";"9377"
"Estreito (MA)";"Total";"Total";"35835";"19017";"16818"
"Feira Nova do Maranhão (MA)";"Total";"Total";"8126";"4266";"3860"
"Fernando Falcão (MA)";"Total";"Total";"9241";"4839";"4402"
"Formosa da Serra Negra (MA)";"Total";"Total";"17757";"9324";"8433"
"Fortaleza dos Nogueiras (MA)";"Total";"Total";"11646";"5972";"5674"
"Fortuna (MA)";"Total";"Total";"15098";"7612";"7486"
"Godofredo Viana (MA)";"Total";"Total";"10635";"5566";"5069"
"Gonçalves Dias (MA)";"Total";"Total";"17482";"8677";"8805"
"Governador Archer (MA)";"Total";"Total";"10205";"5066";"5139"
"Governador Edison Lobão (MA)";"Total";"Total";"15895";"8152";"7743"
"Governador Eugênio Barros (MA)";"Total";"Total";"15991";"8060";"7931"
"Governador Luiz Rocha (MA)";"Total";"Total";"7337";"3750";"3587"
"Governador Newton Bello (MA)";"Total";"Total";"11921";"6015";"5906"
"Governador Nunes Freire (MA)";"Total";"Total";"25401";"12863";"12538"
"Graça Aranha (MA)";"Total";"Total";"6140";"3031";"3109"
"Grajaú (MA)";"Total";"Total";"62093";"31696";"30397"
"Guimarães (MA)";"Total";"Total";"12081";"6140";"5941"
"Humberto de Campos (MA)";"Total";"Total";"26189";"13684";"12505"
"Icatu (MA)";"Total";"Total";"25145";"13092";"12053"
"Igarapé do Meio (MA)";"Total";"Total";"12550";"6348";"6202"
"Igarapé Grande (MA)";"Total";"Total";"11041";"5426";"5615"
"Imperatriz (MA)";"Total";"Total";"247505";"119227";"128278"
"Itaipava do Grajaú (MA)";"Total";"Total";"14297";"7388";"6909"
"Itapecuru Mirim (MA)";"Total";"Total";"62110";"31025";"31085"
"Itinga do Maranhão (MA)";"Total";"Total";"24863";"12588";"12275"
"Jatobá (MA)";"Total";"Total";"8526";"4303";"4223"
"Jenipapo dos Vieiras (MA)";"Total";"Total";"15440";"7976";"7464"
"João Lisboa (MA)";"Total";"Total";"20381";"9977";"10404"
"Joselândia (MA)";"Total";"Total";"15433";"7815";"7618"
"Junco do Maranhão (MA)";"Total";"Total";"4020";"2007";"2013"
"Lago da Pedra (MA)";"Total";"Total";"46083";"22965";"23118"
"Lago do Junco (MA)";"Total";"Total";"10729";"5415";"5314"
"Lago Verde (MA)";"Total";"Total";"15412";"7729";"7683"
"Lagoa do Mato (MA)";"Total";"Total";"10934";"5609";"5325"
"Lago dos Rodrigues (MA)";"Total";"Total";"7794";"3866";"3928"
"Lagoa Grande do Maranhão (MA)";"Total";"Total";"10517";"5544";"4973"
"Lajeado Novo (MA)";"Total";"Total";"6923";"3624";"3299"
"Lima Campos (MA)";"Total";"Total";"11423";"5615";"5808"
"Loreto (MA)";"Total";"Total";"11390";"5870";"5520"
"Luís Domingues (MA)";"Total";"Total";"6510";"3399";"3111"
"Magalhães de Almeida (MA)";"Total";"Total";"17587";"8979";"8608"
"Maracaçumé (MA)";"Total";"Total";"19155";"9593";"9562"
"Marajá do Sena (MA)";"Total";"Total";"8051";"4390";"3661"
"Maranhãozinho (MA)";"Total";"Total";"14065";"7168";"6897"
"Mata Roma (MA)";"Total";"Total";"15150";"7591";"7559"
"Matinha (MA)";"Total";"Total";"21885";"11027";"10858"
"Matões (MA)";"Total";"Total";"31015";"15583";"15432"
"Matões do Norte (MA)";"Total";"Total";"13794";"7241";"6553"
"Milagres do Maranhão (MA)";"Total";"Total";"8118";"4196";"3922"
"Mirador (MA)";"Total";"Total";"20452";"10456";"9996"
"Miranda do Norte (MA)";"Total";"Total";"24427";"11809";"12618"
"Mirinzal (MA)";"Total";"Total";"14218";"7287";"6931"
"Monção (MA)";"Total";"Total";"31738";"16191";"15547"
"Montes Altos (MA)";"Total";"Total";"9413";"4904";"4509"
"Morros (MA)";"Total";"Total";"17783";"9152";"8631"
"Nina Rodrigues (MA)";"Total";"Total";"12464";"6336";"6128"
"Nova Colinas (MA)";"Total";"Total";"4885";"2600";"2285"
"Nova Iorque (MA)";"Total";"Total";"4590";"2331";"2259"
"Nova Olinda do Maranhão (MA)";"Total";"Total";"19134";"9581";"9553"
"Olho d'Água das Cunhãs (MA)";"Total";"Total";"18601";"9185";"9416"
"Olinda Nova do Maranhão (MA)";"Total";"Total";"13181";"6805";"6376"
"Paço do Lumiar (MA)";"Total";"Total";"105121";"50910";"54211"
"Palmeirândia (MA)";"Total";"Total";"18764";"9388";"9376"
"Paraibano (MA)";"Total";"Total";"20103";"9878";"10225"
"Parnarama (MA)";"Total";"Total";"34586";"17524";"17062"
"Passagem Franca (MA)";"Total";"Total";"17562";"8693";"8869"
"Pastos Bons (MA)";"Total";"Total";"18067";"9179";"8888"
"Paulino Neves (MA)";"Total";"Total";"14519";"7502";"7017"
"Paulo Ramos (MA)";"Total";"Total";"20079";"10128";"9951"
"Pedreiras (MA)";"Total";"Total";"39448";"18860";"20588"
"Pedro do Rosário (MA)";"Total";"Total";"22732";"11836";"10896"
"Penalva (MA)";"Total";"Total";"34267";"17403";"16864"
"Peri Mirim (MA)";"Total";"Total";"13803";"6989";"6814"
"Peritoró (MA)";"Total";"Total";"21201";"10569";"10632"
"Pindaré-Mirim (MA)";"Total";"Total";"31152";"15243";"15909"
"Pinheiro (MA)";"Total";"Total";"78162";"38079";"40083"
"Pio XII (MA)";"Total";"Total";"22016";"11004";"11012"
"Pirapemas (MA)";"Total";"Total";"17381";"8666";"8715"
"Poção de Pedras (MA)";"Total";"Total";"19708";"9919";"9789"
"Porto Franco (MA)";"Total";"Total";"21530";"10848";"10682"
"Porto Rico do Maranhão (MA)";"Total";"Total";"6030";"3194";"2836"
"Presidente Dutra (MA)";"Total";"Total";"44731";"21966";"22765"
"Presidente Juscelino (MA)";"Total";"Total";"11541";"6004";"5537"
"Presidente Médici (MA)";"Total";"Total";"6374";"3294";"3080"
"Presidente Sarney (MA)";"Total";"Total";"17165";"8893";"8272"
"Presidente Vargas (MA)";"Total";"Total";"10717";"5460";"5257"
"Primeira Cruz (MA)";"Total";"Total";"13954";"7410";"6544"
"Raposa (MA)";"Total";"Total";"26327";"13121";"13206"
"Riachão (MA)";"Total";"Total";"20209";"10390";"9819"
"Ribamar Fiquene (MA)";"Total";"Total";"7318";"3771";"3547"
"Rosário (MA)";"Total";"Total";"39576";"19658";"19918"
"Sambaíba (MA)";"Total";"Total";"5487";"2894";"2593"
"Santa Filomena do Maranhão (MA)";"Total";"Total";"7061";"3670";"3391"
"Santa Helena (MA)";"Total";"Total";"39110";"19425";"19685"
"Santa Inês (MA)";"Total";"Total";"77282";"36887";"40395"
"Santa Luzia (MA)";"Total";"Total";"74043";"37699";"36344"
"Santa Luzia do Paruá (MA)";"Total";"Total";"22644";"11377";"11267"
"Santa Quitéria do Maranhão (MA)";"Total";"Total";"29191";"14736";"14455"
"Santa Rita (MA)";"Total";"Total";"32366";"16326";"16040"
"Santana do Maranhão (MA)";"Total";"Total";"11661";"6028";"5633"
"Santo Amaro do Maranhão (MA)";"Total";"Total";"13820";"7314";"6506"
"Santo Antônio dos Lopes (MA)";"Total";"Total";"14288";"7190";"7098"
"São Benedito do Rio Preto (MA)";"Total";"Total";"17799";"9040";"8759"
"São Bento (MA)";"Total";"Total";"40736";"19944";"20792"
"São Bernardo (MA)";"Total";"Total";"26476";"13356";"13120"
"São Domingos do Azeitão (MA)";"Total";"Total";"6983";"3566";"3417"
"São Domingos do Maranhão (MA)";"Total";"Total";"33607";"16904";"16703"
"São Félix de Balsas (MA)";"Total";"Total";"4702";"2454";"2248"
"São Francisco do Brejão (MA)";"Total";"Total";"10261";"5268";"4993"
"São Francisco do Maranhão (MA)";"Total";"Total";"12146";"6152";"5994"
"São João Batista (MA)";"Total";"Total";"19920";"10131";"9789"
"São João do Carú (MA)";"Total";"Total";"12309";"6339";"5970"
"São João do Paraíso (MA)";"Total";"Total";"10814";"5777";"5037"
"São João do Soter (MA)";"Total";"Total";"17238";"8816";"8422"
"São João dos Patos (MA)";"Total";"Total";"24928";"12210";"12718"
"São José de Ribamar (MA)";"Total";"Total";"163045";"78683";"84362"
"São José dos Basílios (MA)";"Total";"Total";"7496";"3757";"3739"
"São Luís (MA)";"Total";"Total";"1014837";"474995";"539842"
"São Luís Gonzaga do Maranhão (MA)";"Total";"Total";"20153";"10161";"9992"
"São Mateus do Maranhão (MA)";"Total";"Total";"39093";"19231";"19862"
"São Pedro da Água Branca (MA)";"Total";"Total";"12028";"6115";"5913"
"São Pedro dos Crentes (MA)";"Total";"Total";"4425";"2355";"2070"
"São Raimundo das Mangabeiras (MA)";"Total";"Total";"17474";"8884";"8590"
"São Raimundo do Doca Bezerra (MA)";"Total";"Total";"6090";"3186";"2904"
"São Roberto (MA)";"Total";"Total";"5957";"3091";"2866"
"São Vicente Ferrer (MA)";"Total";"Total";"20863";"10580";"10283"
"Satubinha (MA)";"Total";"Total";"11990";"6170";"5820"
"Senador Alexandre Costa (MA)";"Total";"Total";"10256";"5122";"5134"
"Senador La Rocque (MA)";"Total";"Total";"17998";"9060";"8938"
"Serrano do Maranhão (MA)";"Total";"Total";"10940";"5851";"5089"
"Sítio Novo (MA)";"Total";"Total";"17002";"8942";"8060"
"Sucupira do Norte (MA)";"Total";"Total";"10444";"5337";"5107"
"Sucupira do Riachão (MA)";"Total";"Total";"4613";"2372";"2241"
"Tasso Fragoso (MA)";"Total";"Total";"7796";"3973";"3823"
"Timbiras (MA)";"Total";"Total";"27997";"14092";"13905"
"Timon (MA)";"Total";"Total";"155460";"75561";"79899"
"Trizidela do Vale (MA)";"Total";"Total";"18953";"9141";"9812"
"Tufilândia (MA)";"Total";"Total";"5596";"2857";"2739"
"Tuntum (MA)";"Total";"Total";"39183";"19992";"19191"
"Turiaçu (MA)";"Total";"Total";"33933";"17626";"16307"
"Turilândia (MA)";"Total";"Total";"22846";"11481";"11365"
"Tutóia (MA)";"Total";"Total";"52788";"26680";"26108"
"Urbano Santos (MA)";"Total";"Total";"24573";"12372";"12201"
"Vargem Grande (MA)";"Total";"Total";"49412";"24619";"24793"
"Viana (MA)";"Total";"Total";"49496";"24712";"24784"
"Vila Nova dos Martírios (MA)";"Total";"Total";"11258";"5938";"5320"
"Vitória do Mearim (MA)";"Total";"Total";"31217";"15564";"15653"
"Vitorino Freire (MA)";"Total";"Total";"31658";"15721";"15937"
"Zé Doca (MA)";"Total";"Total";"50173";"24898";"25275"
"Acauã (PI)";"Total";"Total";"6749";"3459";"3290"
"Agricolândia (PI)";"Total";"Total";"5098";"2455";"2643"
"Água Branca (PI)";"Total";"Total";"16451";"7804";"8647"
"Alagoinha do Piauí (PI)";"Total";"Total";"7341";"3683";"3658"
"Alegrete do Piauí (PI)";"Total";"Total";"5153";"2556";"2597"
"Alto Longá (PI)";"Total";"Total";"13646";"6958";"6688"
"Altos (PI)";"Total";"Total";"38822";"19116";"19706"
"Alvorada do Gurguéia (PI)";"Total";"Total";"5050";"2648";"2402"
"Amarante (PI)";"Total";"Total";"17135";"8317";"8818"
"Angical do Piauí (PI)";"Total";"Total";"6672";"3235";"3437"
"Anísio de Abreu (PI)";"Total";"Total";"9098";"4642";"4456"
"Antônio Almeida (PI)";"Total";"Total";"3039";"1558";"1481"
"Aroazes (PI)";"Total";"Total";"5779";"2863";"2916"
"Aroeiras do Itaim (PI)";"Total";"Total";"2440";"1273";"1167"
"Arraial (PI)";"Total";"Total";"4688";"2316";"2372"
"Assunção do Piauí (PI)";"Total";"Total";"7503";"3825";"3678"
"Avelino Lopes (PI)";"Total";"Total";"11067";"5581";"5486"
"Baixa Grande do Ribeiro (PI)";"Total";"Total";"10516";"5468";"5048"
"Barra D'Alcântara (PI)";"Total";"Total";"3852";"1821";"2031"
"Barras (PI)";"Total";"Total";"44850";"22566";"22284"
"Barreiras do Piauí (PI)";"Total";"Total";"3234";"1690";"1544"
"Barro Duro (PI)";"Total";"Total";"6607";"3230";"3377"
"Batalha (PI)";"Total";"Total";"25774";"13048";"12726"
"Bela Vista do Piauí (PI)";"Total";"Total";"3778";"1936";"1842"
"Belém do Piauí (PI)";"Total";"Total";"3284";"1682";"1602"
"Beneditinos (PI)";"Total";"Total";"9911";"5014";"4897"
"Bertolínia (PI)";"Total";"Total";"5319";"2679";"2640"
"Betânia do Piauí (PI)";"Total";"Total";"6015";"3113";"2902"
"Boa Hora (PI)";"Total";"Total";"6296";"3204";"3092"
"Bocaina (PI)";"Total";"Total";"4369";"2149";"2220"
"Bom Jesus (PI)";"Total";"Total";"22629";"11303";"11326"
"Bom Princípio do Piauí (PI)";"Total";"Total";"5304";"2747";"2557"
"Bonfim do Piauí (PI)";"Total";"Total";"5393";"2693";"2700"
"Boqueirão do Piauí (PI)";"Total";"Total";"6193";"3079";"3114"
"Brasileira (PI)";"Total";"Total";"7966";"4075";"3891"
"Brejo do Piauí (PI)";"Total";"Total";"3850";"1944";"1906"
"Buriti dos Lopes (PI)";"Total";"Total";"19074";"9622";"9452"
"Buriti dos Montes (PI)";"Total";"Total";"7974";"4145";"3829"
"Cabeceiras do Piauí (PI)";"Total";"Total";"9928";"5094";"4834"
"Cajazeiras do Piauí (PI)";"Total";"Total";"3343";"1698";"1645"
"Cajueiro da Praia (PI)";"Total";"Total";"7163";"3742";"3421"
"Caldeirão Grande do Piauí (PI)";"Total";"Total";"5671";"2845";"2826"
"Campinas do Piauí (PI)";"Total";"Total";"5408";"2710";"2698"
"Campo Alegre do Fidalgo (PI)";"Total";"Total";"4693";"2404";"2289"
"Campo Grande do Piauí (PI)";"Total";"Total";"5592";"2839";"2753"
"Campo Largo do Piauí (PI)";"Total";"Total";"6803";"3466";"3337"
"Campo Maior (PI)";"Total";"Total";"45177";"21781";"23396"
"Canavieira (PI)";"Total";"Total";"3921";"2029";"1892"
"Canto do Buriti (PI)";"Total";"Total";"20020";"9954";"10066"
"Capitão de Campos (PI)";"Total";"Total";"10953";"5438";"5515"
"Capitão Gervásio Oliveira (PI)";"Total";"Total";"3878";"1999";"1879"
"Caracol (PI)";"Total";"Total";"10212";"5202";"5010"
"Caraúbas do Piauí (PI)";"Total";"Total";"5525";"2837";"2688"
"Caridade do Piauí (PI)";"Total";"Total";"4826";"2500";"2326"
"Castelo do Piauí (PI)";"Total";"Total";"18336";"8982";"9354"
"Caxingó (PI)";"Total";"Total";"5039";"2656";"2383"
"Cocal (PI)";"Total";"Total";"26036";"13165";"12871"
"Cocal de Telha (PI)";"Total";"Total";"4525";"2207";"2318"
"Cocal dos Alves (PI)";"Total";"Total";"5572";"2797";"2775"
"Coivaras (PI)";"Total";"Total";"3811";"1970";"1841"
"Colônia do Gurguéia (PI)";"Total";"Total";"6036";"2963";"3073"
"Colônia do Piauí (PI)";"Total";"Total";"7433";"3701";"3732"
"Conceição do Canindé (PI)";"Total";"Total";"4475";"2247";"2228"
"Coronel José Dias (PI)";"Total";"Total";"4541";"2378";"2163"
"Corrente (PI)";"Total";"Total";"25407";"12844";"12563"
"Cristalândia do Piauí (PI)";"Total";"Total";"7831";"4087";"3744"
"Cristino Castro (PI)";"Total";"Total";"9981";"5036";"4945"
"Curimatá (PI)";"Total";"Total";"10761";"5455";"5306"
"Currais (PI)";"Total";"Total";"4704";"2473";"2231"
"Curralinhos (PI)";"Total";"Total";"4183";"2144";"2039"
"Curral Novo do Piauí (PI)";"Total";"Total";"4869";"2531";"2338"
"Demerval Lobão (PI)";"Total";"Total";"13278";"6477";"6801"
"Dirceu Arcoverde (PI)";"Total";"Total";"6675";"3403";"3272"
"Dom Expedito Lopes (PI)";"Total";"Total";"6569";"3221";"3348"
"Domingos Mourão (PI)";"Total";"Total";"4264";"2156";"2108"
"Dom Inocêncio (PI)";"Total";"Total";"9245";"4733";"4512"
"Elesbão Veloso (PI)";"Total";"Total";"14512";"7148";"7364"
"Eliseu Martins (PI)";"Total";"Total";"4665";"2402";"2263"
"Esperantina (PI)";"Total";"Total";"37767";"18776";"18991"
"Fartura do Piauí (PI)";"Total";"Total";"5074";"2574";"2500"
"Flores do Piauí (PI)";"Total";"Total";"4366";"2219";"2147"
"Floresta do Piauí (PI)";"Total";"Total";"2482";"1272";"1210"
"Floriano (PI)";"Total";"Total";"57690";"27309";"30381"
"Francinópolis (PI)";"Total";"Total";"5235";"2558";"2677"
"Francisco Ayres (PI)";"Total";"Total";"4477";"2221";"2256"
"Francisco Macedo (PI)";"Total";"Total";"2879";"1436";"1443"
"Francisco Santos (PI)";"Total";"Total";"8592";"4383";"4209"
"Fronteiras (PI)";"Total";"Total";"11117";"5478";"5639"
"Geminiano (PI)";"Total";"Total";"5475";"2776";"2699"
"Gilbués (PI)";"Total";"Total";"10402";"5213";"5189"
"Guadalupe (PI)";"Total";"Total";"10268";"5088";"5180"
"Guaribas (PI)";"Total";"Total";"4401";"2216";"2185"
"Hugo Napoleão (PI)";"Total";"Total";"3771";"1839";"1932"
"Ilha Grande (PI)";"Total";"Total";"8914";"4557";"4357"
"Inhuma (PI)";"Total";"Total";"14845";"7319";"7526"
"Ipiranga do Piauí (PI)";"Total";"Total";"9327";"4595";"4732"
"Isaías Coelho (PI)";"Total";"Total";"8221";"4120";"4101"
"Itainópolis (PI)";"Total";"Total";"11109";"5545";"5564"
"Itaueira (PI)";"Total";"Total";"10678";"5385";"5293"
"Jacobina do Piauí (PI)";"Total";"Total";"5722";"2904";"2818"
"Jaicós (PI)";"Total";"Total";"18035";"8800";"9235"
"Jardim do Mulato (PI)";"Total";"Total";"4309";"2182";"2127"
"Jatobá do Piauí (PI)";"Total";"Total";"4656";"2423";"2233"
"Jerumenha (PI)";"Total";"Total";"4390";"2221";"2169"
"João Costa (PI)";"Total";"Total";"2960";"1571";"1389"
"Joaquim Pires (PI)";"Total";"Total";"13817";"7154";"6663"
"Joca Marques (PI)";"Total";"Total";"5100";"2665";"2435"
"José de Freitas (PI)";"Total";"Total";"37085";"18522";"18563"
"Juazeiro do Piauí (PI)";"Total";"Total";"4757";"2419";"2338"
"Júlio Borges (PI)";"Total";"Total";"5373";"2800";"2573"
"Jurema (PI)";"Total";"Total";"4517";"2354";"2163"
"Lagoinha do Piauí (PI)";"Total";"Total";"2656";"1339";"1317"
"Lagoa Alegre (PI)";"Total";"Total";"8008";"4124";"3884"
"Lagoa do Barro do Piauí (PI)";"Total";"Total";"4523";"2321";"2202"
"Lagoa de São Francisco (PI)";"Total";"Total";"6422";"3208";"3214"
"Lagoa do Piauí (PI)";"Total";"Total";"3863";"1990";"1873"
"Lagoa do Sítio (PI)";"Total";"Total";"4850";"2463";"2387"
"Landri Sales (PI)";"Total";"Total";"5281";"2619";"2662"
"Luís Correia (PI)";"Total";"Total";"28406";"14593";"13813"
"Luzilândia (PI)";"Total";"Total";"24721";"12405";"12316"
"Madeiro (PI)";"Total";"Total";"7816";"4044";"3772"
"Manoel Emídio (PI)";"Total";"Total";"5213";"2701";"2512"
"Marcolândia (PI)";"Total";"Total";"7812";"3867";"3945"
"Marcos Parente (PI)";"Total";"Total";"4456";"2219";"2237"
"Massapê do Piauí (PI)";"Total";"Total";"6220";"3152";"3068"
"Matias Olímpio (PI)";"Total";"Total";"10473";"5266";"5207"
"Miguel Alves (PI)";"Total";"Total";"32289";"16359";"15930"
"Miguel Leão (PI)";"Total";"Total";"1253";"657";"596"
"Milton Brandão (PI)";"Total";"Total";"6769";"3441";"3328"
"Monsenhor Gil (PI)";"Total";"Total";"10333";"5105";"5228"
"Monsenhor Hipólito (PI)";"Total";"Total";"7391";"3715";"3676"
"Monte Alegre do Piauí (PI)";"Total";"Total";"10345";"5285";"5060"
"Morro Cabeça no Tempo (PI)";"Total";"Total";"4068";"2061";"2007"
"Morro do Chapéu do Piauí (PI)";"Total";"Total";"6499";"3323";"3176"
"Murici dos Portelas (PI)";"Total";"Total";"8464";"4422";"4042"
"Nazaré do Piauí (PI)";"Total";"Total";"7321";"3667";"3654"
"Nazária (PI)";"Total";"Total";"8068";"4085";"3983"
"Nossa Senhora de Nazaré (PI)";"Total";"Total";"4556";"2331";"2225"
"Nossa Senhora dos Remédios (PI)";"Total";"Total";"8206";"4077";"4129"
"Novo Oriente do Piauí (PI)";"Total";"Total";"6498";"3234";"3264"
"Novo Santo Antônio (PI)";"Total";"Total";"3260";"1672";"1588"
"Oeiras (PI)";"Total";"Total";"35640";"17041";"18599"
"Olho D'Água do Piauí (PI)";"Total";"Total";"2626";"1308";"1318"
"Padre Marcos (PI)";"Total";"Total";"6657";"3229";"3428"
"Paes Landim (PI)";"Total";"Total";"4059";"2048";"2011"
"Pajeú do Piauí (PI)";"Total";"Total";"3363";"1744";"1619"
"Palmeira do Piauí (PI)";"Total";"Total";"4993";"2571";"2422"
"Palmeirais (PI)";"Total";"Total";"13745";"6781";"6964"
"Paquetá (PI)";"Total";"Total";"4147";"2143";"2004"
"Parnaguá (PI)";"Total";"Total";"10276";"5459";"4817"
"Parnaíba (PI)";"Total";"Total";"145705";"69727";"75978"
"Passagem Franca do Piauí (PI)";"Total";"Total";"4546";"2316";"2230"
"Patos do Piauí (PI)";"Total";"Total";"6105";"3093";"3012"
"Pau D'Arco do Piauí (PI)";"Total";"Total";"3757";"1935";"1822"
"Paulistana (PI)";"Total";"Total";"19785";"9567";"10218"
"Pavussu (PI)";"Total";"Total";"3663";"1950";"1713"
"Pedro II (PI)";"Total";"Total";"37496";"18443";"19053"
"Pedro Laurentino (PI)";"Total";"Total";"2407";"1251";"1156"
"Nova Santa Rita (PI)";"Total";"Total";"4187";"2152";"2035"
"Picos (PI)";"Total";"Total";"73414";"35061";"38353"
"Pimenteiras (PI)";"Total";"Total";"11733";"5998";"5735"
"Pio IX (PI)";"Total";"Total";"17671";"8820";"8851"
"Piracuruca (PI)";"Total";"Total";"27553";"13628";"13925"
"Piripiri (PI)";"Total";"Total";"61834";"30138";"31696"
"Porto (PI)";"Total";"Total";"11897";"6009";"5888"
"Porto Alegre do Piauí (PI)";"Total";"Total";"2559";"1324";"1235"
"Prata do Piauí (PI)";"Total";"Total";"3085";"1551";"1534"
"Queimada Nova (PI)";"Total";"Total";"8553";"4280";"4273"
"Redenção do Gurguéia (PI)";"Total";"Total";"8400";"4223";"4177"
"Regeneração (PI)";"Total";"Total";"17556";"8590";"8966"
"Riacho Frio (PI)";"Total";"Total";"4241";"2220";"2021"
"Ribeira do Piauí (PI)";"Total";"Total";"4263";"2138";"2125"
"Ribeiro Gonçalves (PI)";"Total";"Total";"6845";"3511";"3334"
"Rio Grande do Piauí (PI)";"Total";"Total";"6273";"3113";"3160"
"Santa Cruz do Piauí (PI)";"Total";"Total";"6027";"2973";"3054"
"Santa Cruz dos Milagres (PI)";"Total";"Total";"3794";"1884";"1910"
"Santa Filomena (PI)";"Total";"Total";"6096";"3217";"2879"
"Santa Luz (PI)";"Total";"Total";"5513";"2868";"2645"
"Santana do Piauí (PI)";"Total";"Total";"4917";"2399";"2518"
"Santa Rosa do Piauí (PI)";"Total";"Total";"5149";"2582";"2567"
"Santo Antônio de Lisboa (PI)";"Total";"Total";"6007";"2976";"3031"
"Santo Antônio dos Milagres (PI)";"Total";"Total";"2059";"1023";"1036"
"Santo Inácio do Piauí (PI)";"Total";"Total";"3648";"1851";"1797"
"São Braz do Piauí (PI)";"Total";"Total";"4313";"2240";"2073"
"São Félix do Piauí (PI)";"Total";"Total";"3069";"1500";"1569"
"São Francisco de Assis do Piauí (PI)";"Total";"Total";"5567";"2832";"2735"
"São Francisco do Piauí (PI)";"Total";"Total";"6298";"3190";"3108"
"São Gonçalo do Gurguéia (PI)";"Total";"Total";"2825";"1464";"1361"
"São Gonçalo do Piauí (PI)";"Total";"Total";"4754";"2353";"2401"
"São João da Canabrava (PI)";"Total";"Total";"4445";"2188";"2257"
"São João da Fronteira (PI)";"Total";"Total";"5608";"2805";"2803"
"São João da Serra (PI)";"Total";"Total";"6157";"3012";"3145"
"São João da Varjota (PI)";"Total";"Total";"4651";"2284";"2367"
"São João do Arraial (PI)";"Total";"Total";"7336";"3695";"3641"
"São João do Piauí (PI)";"Total";"Total";"19548";"9584";"9964"
"São José do Divino (PI)";"Total";"Total";"5148";"2653";"2495"
"São José do Peixe (PI)";"Total";"Total";"3700";"1885";"1815"
"São José do Piauí (PI)";"Total";"Total";"6591";"3281";"3310"
"São Julião (PI)";"Total";"Total";"5675";"2829";"2846"
"São Lourenço do Piauí (PI)";"Total";"Total";"4427";"2266";"2161"
"São Luis do Piauí (PI)";"Total";"Total";"2561";"1262";"1299"
"São Miguel da Baixa Grande (PI)";"Total";"Total";"2110";"1050";"1060"
"São Miguel do Fidalgo (PI)";"Total";"Total";"2976";"1546";"1430"
"São Miguel do Tapuio (PI)";"Total";"Total";"18134";"9219";"8915"
"São Pedro do Piauí (PI)";"Total";"Total";"13639";"6822";"6817"
"São Raimundo Nonato (PI)";"Total";"Total";"32327";"15897";"16430"
"Sebastião Barros (PI)";"Total";"Total";"3560";"1889";"1671"
"Sebastião Leal (PI)";"Total";"Total";"4116";"2151";"1965"
"Sigefredo Pacheco (PI)";"Total";"Total";"9619";"4972";"4647"
"Simões (PI)";"Total";"Total";"14180";"7078";"7102"
"Simplício Mendes (PI)";"Total";"Total";"12077";"6090";"5987"
"Socorro do Piauí (PI)";"Total";"Total";"4522";"2301";"2221"
"Sussuapara (PI)";"Total";"Total";"6229";"3099";"3130"
"Tamboril do Piauí (PI)";"Total";"Total";"2753";"1443";"1310"
"Tanque do Piauí (PI)";"Total";"Total";"2620";"1276";"1344"
"Teresina (PI)";"Total";"Total";"814230";"380612";"433618"
"União (PI)";"Total";"Total";"42654";"21404";"21250"
"Uruçuí (PI)";"Total";"Total";"20149";"9909";"10240"
"Valença do Piauí (PI)";"Total";"Total";"20326";"9577";"10749"
"Várzea Branca (PI)";"Total";"Total";"4913";"2498";"2415"
"Várzea Grande (PI)";"Total";"Total";"4336";"2048";"2288"
"Vera Mendes (PI)";"Total";"Total";"2986";"1492";"1494"
"Vila Nova do Piauí (PI)";"Total";"Total";"3076";"1576";"1500"
"Wall Ferraz (PI)";"Total";"Total";"4280";"2165";"2115"
"Abaiara (CE)";"Total";"Total";"10496";"5210";"5286"
"Acarape (CE)";"Total";"Total";"15338";"7571";"7767"
"Acaraú (CE)";"Total";"Total";"57551";"29102";"28449"
"Acopiara (CE)";"Total";"Total";"51160";"25624";"25536"
"Aiuaba (CE)";"Total";"Total";"16203";"8117";"8086"
"Alcântaras (CE)";"Total";"Total";"10771";"5314";"5457"
"Altaneira (CE)";"Total";"Total";"6856";"3317";"3539"
"Alto Santo (CE)";"Total";"Total";"16359";"8217";"8142"
"Amontada (CE)";"Total";"Total";"39232";"20356";"18876"
"Antonina do Norte (CE)";"Total";"Total";"6984";"3344";"3640"
"Apuiarés (CE)";"Total";"Total";"13925";"7072";"6853"
"Aquiraz (CE)";"Total";"Total";"72628";"37130";"35498"
"Aracati (CE)";"Total";"Total";"69159";"34147";"35012"
"Aracoiaba (CE)";"Total";"Total";"25391";"12788";"12603"
"Ararendá (CE)";"Total";"Total";"10491";"5180";"5311"
"Araripe (CE)";"Total";"Total";"20685";"10292";"10393"
"Aratuba (CE)";"Total";"Total";"11529";"5823";"5706"
"Arneiroz (CE)";"Total";"Total";"7650";"3850";"3800"
"Assaré (CE)";"Total";"Total";"22445";"11080";"11365"
"Aurora (CE)";"Total";"Total";"24566";"12224";"12342"
"Baixio (CE)";"Total";"Total";"6026";"3055";"2971"
"Banabuiú (CE)";"Total";"Total";"17315";"8737";"8578"
"Barbalha (CE)";"Total";"Total";"55323";"26904";"28419"
"Barreira (CE)";"Total";"Total";"19573";"9736";"9837"
"Barro (CE)";"Total";"Total";"21514";"10627";"10887"
"Barroquinha (CE)";"Total";"Total";"14476";"7321";"7155"
"Baturité (CE)";"Total";"Total";"33321";"16396";"16925"
"Beberibe (CE)";"Total";"Total";"49311";"24857";"24454"
"Bela Cruz (CE)";"Total";"Total";"30878";"15701";"15177"
"Boa Viagem (CE)";"Total";"Total";"52498";"26340";"26158"
"Brejo Santo (CE)";"Total";"Total";"45193";"21918";"23275"
"Camocim (CE)";"Total";"Total";"60158";"29770";"30388"
"Campos Sales (CE)";"Total";"Total";"26506";"12706";"13800"
"Canindé (CE)";"Total";"Total";"74473";"36912";"37561"
"Capistrano (CE)";"Total";"Total";"17062";"8638";"8424"
"Caridade (CE)";"Total";"Total";"20020";"10124";"9896"
"Cariré (CE)";"Total";"Total";"18347";"9142";"9205"
"Caririaçu (CE)";"Total";"Total";"26393";"12812";"13581"
"Cariús (CE)";"Total";"Total";"18567";"9334";"9233"
"Carnaubal (CE)";"Total";"Total";"16746";"8347";"8399"
"Cascavel (CE)";"Total";"Total";"66142";"32887";"33255"
"Catarina (CE)";"Total";"Total";"18745";"9302";"9443"
"Catunda (CE)";"Total";"Total";"9952";"5033";"4919"
"Caucaia (CE)";"Total";"Total";"325441";"159598";"165843"
"Cedro (CE)";"Total";"Total";"24527";"12108";"12419"
"Chaval (CE)";"Total";"Total";"12615";"6194";"6421"
"Choró (CE)";"Total";"Total";"12853";"6586";"6267"
"Chorozinho (CE)";"Total";"Total";"18915";"9600";"9315"
"Coreaú (CE)";"Total";"Total";"21954";"10944";"11010"
"Crateús (CE)";"Total";"Total";"72812";"35509";"37303"
"Crato (CE)";"Total";"Total";"121428";"57616";"63812"
"Croatá (CE)";"Total";"Total";"17069";"8328";"8741"
"Cruz (CE)";"Total";"Total";"22479";"11091";"11388"
"Deputado Irapuan Pinheiro (CE)";"Total";"Total";"9095";"4562";"4533"
"Ererê (CE)";"Total";"Total";"6840";"3428";"3412"
"Eusébio (CE)";"Total";"Total";"46033";"22951";"23082"
"Farias Brito (CE)";"Total";"Total";"19007";"9329";"9678"
"Forquilha (CE)";"Total";"Total";"21786";"10786";"11000"
"Fortaleza (CE)";"Total";"Total";"2452185";"1147918";"1304267"
"Fortim (CE)";"Total";"Total";"14817";"7456";"7361"
"Frecheirinha (CE)";"Total";"Total";"12991";"6378";"6613"
"General Sampaio (CE)";"Total";"Total";"6218";"3164";"3054"
"Graça (CE)";"Total";"Total";"15049";"7439";"7610"
"Granja (CE)";"Total";"Total";"52645";"26714";"25931"
"Granjeiro (CE)";"Total";"Total";"4629";"2263";"2366"
"Groaíras (CE)";"Total";"Total";"10228";"5045";"5183"
"Guaiúba (CE)";"Total";"Total";"24091";"12139";"11952"
"Guaraciaba do Norte (CE)";"Total";"Total";"37775";"18660";"19115"
"Guaramiranga (CE)";"Total";"Total";"4164";"2099";"2065"
"Hidrolândia (CE)";"Total";"Total";"19325";"9626";"9699"
"Horizonte (CE)";"Total";"Total";"55187";"27532";"27655"
"Ibaretama (CE)";"Total";"Total";"12922";"6667";"6255"
"Ibiapina (CE)";"Total";"Total";"23808";"11933";"11875"
"Ibicuitinga (CE)";"Total";"Total";"11335";"5865";"5470"
"Icapuí (CE)";"Total";"Total";"18392";"9414";"8978"
"Icó (CE)";"Total";"Total";"65456";"31881";"33575"
"Iguatu (CE)";"Total";"Total";"96495";"46425";"50070"
"Independência (CE)";"Total";"Total";"25573";"12741";"12832"
"Ipaporanga (CE)";"Total";"Total";"11343";"5658";"5685"
"Ipaumirim (CE)";"Total";"Total";"12009";"5996";"6013"
"Ipu (CE)";"Total";"Total";"40296";"19956";"20340"
"Ipueiras (CE)";"Total";"Total";"37862";"18533";"19329"
"Iracema (CE)";"Total";"Total";"13722";"6763";"6959"
"Irauçuba (CE)";"Total";"Total";"22324";"11347";"10977"
"Itaiçaba (CE)";"Total";"Total";"7316";"3642";"3674"
"Itaitinga (CE)";"Total";"Total";"35817";"18288";"17529"
"Itapajé (CE)";"Total";"Total";"48350";"23990";"24360"
"Itapipoca (CE)";"Total";"Total";"116065";"58243";"57822"
"Itapiúna (CE)";"Total";"Total";"18626";"9461";"9165"
"Itarema (CE)";"Total";"Total";"37471";"19351";"18120"
"Itatira (CE)";"Total";"Total";"18894";"9589";"9305"
"Jaguaretama (CE)";"Total";"Total";"17863";"9071";"8792"
"Jaguaribara (CE)";"Total";"Total";"10399";"5277";"5122"
"Jaguaribe (CE)";"Total";"Total";"34409";"16829";"17580"
"Jaguaruana (CE)";"Total";"Total";"32236";"16076";"16160"
"Jardim (CE)";"Total";"Total";"26688";"13067";"13621"
"Jati (CE)";"Total";"Total";"7660";"3830";"3830"
"Jijoca de Jericoacoara (CE)";"Total";"Total";"17002";"8520";"8482"
"Juazeiro do Norte (CE)";"Total";"Total";"249939";"118353";"131586"
"Jucás (CE)";"Total";"Total";"23807";"11766";"12041"
"Lavras da Mangabeira (CE)";"Total";"Total";"31090";"15568";"15522"
"Limoeiro do Norte (CE)";"Total";"Total";"56264";"27577";"28687"
"Madalena (CE)";"Total";"Total";"18088";"9083";"9005"
"Maracanaú (CE)";"Total";"Total";"209057";"102078";"106979"
"Maranguape (CE)";"Total";"Total";"113561";"56619";"56942"
"Marco (CE)";"Total";"Total";"24703";"12599";"12104"
"Martinópole (CE)";"Total";"Total";"10214";"5100";"5114"
"Massapê (CE)";"Total";"Total";"35191";"17444";"17747"
"Mauriti (CE)";"Total";"Total";"44240";"22091";"22149"
"Meruoca (CE)";"Total";"Total";"13693";"6874";"6819"
"Milagres (CE)";"Total";"Total";"28316";"13926";"14390"
"Milhã (CE)";"Total";"Total";"13086";"6528";"6558"
"Miraíma (CE)";"Total";"Total";"12800";"6607";"6193"
"Missão Velha (CE)";"Total";"Total";"34274";"16915";"17359"
"Mombaça (CE)";"Total";"Total";"42690";"21249";"21441"
"Monsenhor Tabosa (CE)";"Total";"Total";"16705";"8295";"8410"
"Morada Nova (CE)";"Total";"Total";"62065";"31143";"30922"
"Moraújo (CE)";"Total";"Total";"8070";"4070";"4000"
"Morrinhos (CE)";"Total";"Total";"20700";"10440";"10260"
"Mucambo (CE)";"Total";"Total";"14102";"6699";"7403"
"Mulungu (CE)";"Total";"Total";"11485";"5842";"5643"
"Nova Olinda (CE)";"Total";"Total";"14256";"7020";"7236"
"Nova Russas (CE)";"Total";"Total";"30965";"15024";"15941"
"Novo Oriente (CE)";"Total";"Total";"27453";"13549";"13904"
"Ocara (CE)";"Total";"Total";"24007";"12317";"11690"
"Orós (CE)";"Total";"Total";"21389";"10421";"10968"
"Pacajus (CE)";"Total";"Total";"61838";"30370";"31468"
"Pacatuba (CE)";"Total";"Total";"72299";"35599";"36700"
"Pacoti (CE)";"Total";"Total";"11607";"5850";"5757"
"Pacujá (CE)";"Total";"Total";"5986";"2902";"3084"
"Palhano (CE)";"Total";"Total";"8866";"4470";"4396"
"Palmácia (CE)";"Total";"Total";"12005";"6002";"6003"
"Paracuru (CE)";"Total";"Total";"31636";"15852";"15784"
"Paraipaba (CE)";"Total";"Total";"30041";"15291";"14750"
"Parambu (CE)";"Total";"Total";"31309";"15262";"16047"
"Paramoti (CE)";"Total";"Total";"11308";"5814";"5494"
"Pedra Branca (CE)";"Total";"Total";"41890";"20697";"21193"
"Penaforte (CE)";"Total";"Total";"8226";"4044";"4182"
"Pentecoste (CE)";"Total";"Total";"35400";"17899";"17501"
"Pereiro (CE)";"Total";"Total";"15757";"7762";"7995"
"Pindoretama (CE)";"Total";"Total";"18683";"9340";"9343"
"Piquet Carneiro (CE)";"Total";"Total";"15467";"7790";"7677"
"Pires Ferreira (CE)";"Total";"Total";"10216";"5139";"5077"
"Poranga (CE)";"Total";"Total";"12001";"5974";"6027"
"Porteiras (CE)";"Total";"Total";"15061";"7366";"7695"
"Potengi (CE)";"Total";"Total";"10276";"4987";"5289"
"Potiretama (CE)";"Total";"Total";"6126";"3159";"2967"
"Quiterianópolis (CE)";"Total";"Total";"19921";"9852";"10069"
"Quixadá (CE)";"Total";"Total";"80604";"39769";"40835"
"Quixelô (CE)";"Total";"Total";"15000";"7549";"7451"
"Quixeramobim (CE)";"Total";"Total";"71887";"35729";"36158"
"Quixeré (CE)";"Total";"Total";"19412";"9706";"9706"
"Redenção (CE)";"Total";"Total";"26415";"13122";"13293"
"Reriutaba (CE)";"Total";"Total";"19455";"9681";"9774"
"Russas (CE)";"Total";"Total";"69833";"34405";"35428"
"Saboeiro (CE)";"Total";"Total";"15752";"7762";"7990"
"Salitre (CE)";"Total";"Total";"15453";"7770";"7683"
"Santana do Acaraú (CE)";"Total";"Total";"29946";"15171";"14775"
"Santana do Cariri (CE)";"Total";"Total";"17170";"8640";"8530"
"Santa Quitéria (CE)";"Total";"Total";"42763";"21441";"21322"
"São Benedito (CE)";"Total";"Total";"44178";"21829";"22349"
"São Gonçalo do Amarante (CE)";"Total";"Total";"43890";"22348";"21542"
"São João do Jaguaribe (CE)";"Total";"Total";"7900";"3852";"4048"
"São Luís do Curu (CE)";"Total";"Total";"12332";"6142";"6190"
"Senador Pompeu (CE)";"Total";"Total";"26469";"13019";"13450"
"Senador Sá (CE)";"Total";"Total";"6852";"3431";"3421"
"Sobral (CE)";"Total";"Total";"188233";"91462";"96771"
"Solonópole (CE)";"Total";"Total";"17665";"8838";"8827"
"Tabuleiro do Norte (CE)";"Total";"Total";"29204";"14214";"14990"
"Tamboril (CE)";"Total";"Total";"25451";"12631";"12820"
"Tarrafas (CE)";"Total";"Total";"8910";"4452";"4458"
"Tauá (CE)";"Total";"Total";"55716";"27357";"28359"
"Tejuçuoca (CE)";"Total";"Total";"16827";"8608";"8219"
"Tianguá (CE)";"Total";"Total";"68892";"34175";"34717"
"Trairi (CE)";"Total";"Total";"51422";"26437";"24985"
"Tururu (CE)";"Total";"Total";"14408";"7473";"6935"
"Ubajara (CE)";"Total";"Total";"31787";"15760";"16027"
"Umari (CE)";"Total";"Total";"7545";"3772";"3773"
"Umirim (CE)";"Total";"Total";"18802";"9641";"9161"
"Uruburetama (CE)";"Total";"Total";"19765";"9925";"9840"
"Uruoca (CE)";"Total";"Total";"12883";"6498";"6385"
"Varjota (CE)";"Total";"Total";"17593";"8705";"8888"
"Várzea Alegre (CE)";"Total";"Total";"38434";"18660";"19774"
"Viçosa do Ceará (CE)";"Total";"Total";"54955";"27663";"27292"
"Acari (RN)";"Total";"Total";"11035";"5364";"5671"
"Açu (RN)";"Total";"Total";"53227";"26141";"27086"
"Afonso Bezerra (RN)";"Total";"Total";"10844";"5451";"5393"
"Água Nova (RN)";"Total";"Total";"2980";"1480";"1500"
"Alexandria (RN)";"Total";"Total";"13507";"6616";"6891"
"Almino Afonso (RN)";"Total";"Total";"4871";"2497";"2374"
"Alto do Rodrigues (RN)";"Total";"Total";"12305";"6165";"6140"
"Angicos (RN)";"Total";"Total";"11549";"5656";"5893"
"Antônio Martins (RN)";"Total";"Total";"6907";"3494";"3413"
"Apodi (RN)";"Total";"Total";"34763";"17376";"17387"
"Areia Branca (RN)";"Total";"Total";"25315";"12345";"12970"
"Arês (RN)";"Total";"Total";"12924";"6410";"6514"
"Augusto Severo (RN)";"Total";"Total";"9289";"4708";"4581"
"Baía Formosa (RN)";"Total";"Total";"8573";"4333";"4240"
"Baraúna (RN)";"Total";"Total";"24182";"12271";"11911"
"Barcelona (RN)";"Total";"Total";"3950";"2020";"1930"
"Bento Fernandes (RN)";"Total";"Total";"5113";"2630";"2483"
"Bodó (RN)";"Total";"Total";"2425";"1260";"1165"
"Bom Jesus (RN)";"Total";"Total";"9440";"4708";"4732"
"Brejinho (RN)";"Total";"Total";"11577";"5800";"5777"
"Caiçara do Norte (RN)";"Total";"Total";"6016";"3119";"2897"
"Caiçara do Rio do Vento (RN)";"Total";"Total";"3308";"1644";"1664"
"Caicó (RN)";"Total";"Total";"62709";"30373";"32336"
"Campo Redondo (RN)";"Total";"Total";"10266";"5104";"5162"
"Canguaretama (RN)";"Total";"Total";"30916";"15472";"15444"
"Caraúbas (RN)";"Total";"Total";"19576";"9568";"10008"
"Carnaúba dos Dantas (RN)";"Total";"Total";"7429";"3716";"3713"
"Carnaubais (RN)";"Total";"Total";"9762";"4896";"4866"
"Ceará-Mirim (RN)";"Total";"Total";"68141";"33747";"34394"
"Cerro Corá (RN)";"Total";"Total";"10916";"5459";"5457"
"Coronel Ezequiel (RN)";"Total";"Total";"5405";"2747";"2658"
"Coronel João Pessoa (RN)";"Total";"Total";"4772";"2368";"2404"
"Cruzeta (RN)";"Total";"Total";"7967";"3906";"4061"
"Currais Novos (RN)";"Total";"Total";"42652";"20373";"22279"
"Doutor Severiano (RN)";"Total";"Total";"6492";"3193";"3299"
"Parnamirim (RN)";"Total";"Total";"202456";"96995";"105461"
"Encanto (RN)";"Total";"Total";"5231";"2565";"2666"
"Equador (RN)";"Total";"Total";"5822";"2960";"2862"
"Espírito Santo (RN)";"Total";"Total";"10475";"5319";"5156"
"Extremoz (RN)";"Total";"Total";"24569";"12195";"12374"
"Felipe Guerra (RN)";"Total";"Total";"5734";"2869";"2865"
"Fernando Pedroza (RN)";"Total";"Total";"2854";"1456";"1398"
"Florânia (RN)";"Total";"Total";"8959";"4492";"4467"
"Francisco Dantas (RN)";"Total";"Total";"2874";"1457";"1417"
"Frutuoso Gomes (RN)";"Total";"Total";"4233";"2072";"2161"
"Galinhos (RN)";"Total";"Total";"2159";"1115";"1044"
"Goianinha (RN)";"Total";"Total";"22481";"11202";"11279"
"Governador Dix-Sept Rosado (RN)";"Total";"Total";"12374";"6318";"6056"
"Grossos (RN)";"Total";"Total";"9393";"4762";"4631"
"Guamaré (RN)";"Total";"Total";"12404";"6223";"6181"
"Ielmo Marinho (RN)";"Total";"Total";"12171";"6276";"5895"
"Ipanguaçu (RN)";"Total";"Total";"13856";"7002";"6854"
"Ipueira (RN)";"Total";"Total";"2077";"1038";"1039"
"Itajá (RN)";"Total";"Total";"6932";"3543";"3389"
"Itaú (RN)";"Total";"Total";"5564";"2741";"2823"
"Jaçanã (RN)";"Total";"Total";"7925";"3935";"3990"
"Jandaíra (RN)";"Total";"Total";"6801";"3514";"3287"
"Janduís (RN)";"Total";"Total";"5345";"2650";"2695"
"Januário Cicco (RN)";"Total";"Total";"9011";"4637";"4374"
"Japi (RN)";"Total";"Total";"5522";"2806";"2716"
"Jardim de Angicos (RN)";"Total";"Total";"2607";"1353";"1254"
"Jardim de Piranhas (RN)";"Total";"Total";"13506";"6724";"6782"
"Jardim do Seridó (RN)";"Total";"Total";"12113";"5886";"6227"
"João Câmara (RN)";"Total";"Total";"32227";"16042";"16185"
"João Dias (RN)";"Total";"Total";"2601";"1281";"1320"
"José da Penha (RN)";"Total";"Total";"5868";"2822";"3046"
"Jucurutu (RN)";"Total";"Total";"17692";"8869";"8823"
"Jundiá (RN)";"Total";"Total";"3582";"1878";"1704"
"Lagoa d'Anta (RN)";"Total";"Total";"6227";"3132";"3095"
"Lagoa de Pedras (RN)";"Total";"Total";"6989";"3565";"3424"
"Lagoa de Velhos (RN)";"Total";"Total";"2668";"1367";"1301"
"Lagoa Nova (RN)";"Total";"Total";"13983";"6924";"7059"
"Lagoa Salgada (RN)";"Total";"Total";"7564";"3800";"3764"
"Lajes (RN)";"Total";"Total";"10381";"5164";"5217"
"Lajes Pintadas (RN)";"Total";"Total";"4612";"2348";"2264"
"Lucrécia (RN)";"Total";"Total";"3633";"1829";"1804"
"Luís Gomes (RN)";"Total";"Total";"9610";"4723";"4887"
"Macaíba (RN)";"Total";"Total";"69467";"34434";"35033"
"Macau (RN)";"Total";"Total";"28954";"14182";"14772"
"Major Sales (RN)";"Total";"Total";"3536";"1749";"1787"
"Marcelino Vieira (RN)";"Total";"Total";"8265";"4064";"4201"
"Martins (RN)";"Total";"Total";"8218";"4043";"4175"
"Maxaranguape (RN)";"Total";"Total";"10441";"5350";"5091"
"Messias Targino (RN)";"Total";"Total";"4188";"2119";"2069"
"Montanhas (RN)";"Total";"Total";"11413";"5665";"5748"
"Monte Alegre (RN)";"Total";"Total";"20685";"10275";"10410"
"Monte das Gameleiras (RN)";"Total";"Total";"2261";"1154";"1107"
"Mossoró (RN)";"Total";"Total";"259815";"125747";"134068"
"Natal (RN)";"Total";"Total";"803739";"377947";"425792"
"Nísia Floresta (RN)";"Total";"Total";"23784";"12288";"11496"
"Nova Cruz (RN)";"Total";"Total";"35490";"17499";"17991"
"Olho d'Água do Borges (RN)";"Total";"Total";"4295";"2211";"2084"
"Ouro Branco (RN)";"Total";"Total";"4699";"2354";"2345"
"Paraná (RN)";"Total";"Total";"3952";"2041";"1911"
"Paraú (RN)";"Total";"Total";"3859";"1925";"1934"
"Parazinho (RN)";"Total";"Total";"4845";"2434";"2411"
"Parelhas (RN)";"Total";"Total";"20354";"9961";"10393"
"Rio do Fogo (RN)";"Total";"Total";"10059";"5134";"4925"
"Passa e Fica (RN)";"Total";"Total";"11100";"5508";"5592"
"Passagem (RN)";"Total";"Total";"2895";"1454";"1441"
"Patu (RN)";"Total";"Total";"11964";"5886";"6078"
"Santa Maria (RN)";"Total";"Total";"4762";"2419";"2343"
"Pau dos Ferros (RN)";"Total";"Total";"27745";"13516";"14229"
"Pedra Grande (RN)";"Total";"Total";"3521";"1772";"1749"
"Pedra Preta (RN)";"Total";"Total";"2590";"1340";"1250"
"Pedro Avelino (RN)";"Total";"Total";"7171";"3691";"3480"
"Pedro Velho (RN)";"Total";"Total";"14114";"7160";"6954"
"Pendências (RN)";"Total";"Total";"13432";"6693";"6739"
"Pilões (RN)";"Total";"Total";"3453";"1729";"1724"
"Poço Branco (RN)";"Total";"Total";"13949";"7057";"6892"
"Portalegre (RN)";"Total";"Total";"7320";"3585";"3735"
"Porto do Mangue (RN)";"Total";"Total";"5217";"2730";"2487"
"Serra Caiada (RN)";"Total";"Total";"8768";"4471";"4297"
"Pureza (RN)";"Total";"Total";"8424";"4277";"4147"
"Rafael Fernandes (RN)";"Total";"Total";"4692";"2328";"2364"
"Rafael Godeiro (RN)";"Total";"Total";"3063";"1537";"1526"
"Riacho da Cruz (RN)";"Total";"Total";"3165";"1617";"1548"
"Riacho de Santana (RN)";"Total";"Total";"4156";"2073";"2083"
"Riachuelo (RN)";"Total";"Total";"7067";"3560";"3507"
"Rodolfo Fernandes (RN)";"Total";"Total";"4418";"2173";"2245"
"Tibau (RN)";"Total";"Total";"3687";"1847";"1840"
"Ruy Barbosa (RN)";"Total";"Total";"3595";"1835";"1760"
"Santa Cruz (RN)";"Total";"Total";"35797";"17472";"18325"
"Santana do Matos (RN)";"Total";"Total";"13809";"6869";"6940"
"Santana do Seridó (RN)";"Total";"Total";"2526";"1267";"1259"
"Santo Antônio (RN)";"Total";"Total";"22216";"11099";"11117"
"São Bento do Norte (RN)";"Total";"Total";"2975";"1524";"1451"
"São Bento do Trairí (RN)";"Total";"Total";"3905";"1940";"1965"
"São Fernando (RN)";"Total";"Total";"3401";"1737";"1664"
"São Francisco do Oeste (RN)";"Total";"Total";"3874";"1945";"1929"
"São Gonçalo do Amarante (RN)";"Total";"Total";"87668";"43179";"44489"
"São João do Sabugi (RN)";"Total";"Total";"5922";"2923";"2999"
"São José de Mipibu (RN)";"Total";"Total";"39776";"19844";"19932"
"São José do Campestre (RN)";"Total";"Total";"12356";"6150";"6206"
"São José do Seridó (RN)";"Total";"Total";"4231";"2122";"2109"
"São Miguel (RN)";"Total";"Total";"22157";"10572";"11585"
"São Miguel do Gostoso (RN)";"Total";"Total";"8670";"4474";"4196"
"São Paulo do Potengi (RN)";"Total";"Total";"15843";"7824";"8019"
"São Pedro (RN)";"Total";"Total";"6235";"3172";"3063"
"São Rafael (RN)";"Total";"Total";"8111";"4130";"3981"
"São Tomé (RN)";"Total";"Total";"10827";"5436";"5391"
"São Vicente (RN)";"Total";"Total";"6028";"2944";"3084"
"Senador Elói de Souza (RN)";"Total";"Total";"5637";"2860";"2777"
"Senador Georgino Avelino (RN)";"Total";"Total";"3924";"1944";"1980"
"Serra de São Bento (RN)";"Total";"Total";"5743";"2865";"2878"
"Serra do Mel (RN)";"Total";"Total";"10287";"5392";"4895"
"Serra Negra do Norte (RN)";"Total";"Total";"7770";"3901";"3869"
"Serrinha (RN)";"Total";"Total";"6581";"3452";"3129"
"Serrinha dos Pintos (RN)";"Total";"Total";"4540";"2293";"2247"
"Severiano Melo (RN)";"Total";"Total";"5752";"2865";"2887"
"Sítio Novo (RN)";"Total";"Total";"5020";"2542";"2478"
"Taboleiro Grande (RN)";"Total";"Total";"2317";"1178";"1139"
"Taipu (RN)";"Total";"Total";"11836";"6112";"5724"
"Tangará (RN)";"Total";"Total";"14175";"7159";"7016"
"Tenente Ananias (RN)";"Total";"Total";"9883";"4979";"4904"
"Tenente Laurentino Cruz (RN)";"Total";"Total";"5406";"2746";"2660"
"Tibau do Sul (RN)";"Total";"Total";"11385";"5758";"5627"
"Timbaúba dos Batistas (RN)";"Total";"Total";"2295";"1145";"1150"
"Touros (RN)";"Total";"Total";"31089";"16068";"15021"
"Triunfo Potiguar (RN)";"Total";"Total";"3368";"1770";"1598"
"Umarizal (RN)";"Total";"Total";"10659";"5228";"5431"
"Upanema (RN)";"Total";"Total";"12992";"6719";"6273"
"Várzea (RN)";"Total";"Total";"5236";"2622";"2614"
"Venha-Ver (RN)";"Total";"Total";"3821";"1952";"1869"
"Vera Cruz (RN)";"Total";"Total";"10719";"5355";"5364"
"Viçosa (RN)";"Total";"Total";"1618";"806";"812"
"Vila Flor (RN)";"Total";"Total";"2872";"1460";"1412"
"Água Branca (PB)";"Total";"Total";"9449";"4719";"4730"
"Aguiar (PB)";"Total";"Total";"5530";"2706";"2824"
"Alagoa Grande (PB)";"Total";"Total";"28479";"13861";"14618"
"Alagoa Nova (PB)";"Total";"Total";"19681";"9761";"9920"
"Alagoinha (PB)";"Total";"Total";"13576";"6704";"6872"
"Alcantil (PB)";"Total";"Total";"5239";"2624";"2615"
"Algodão de Jandaíra (PB)";"Total";"Total";"2366";"1217";"1149"
"Alhandra (PB)";"Total";"Total";"18007";"8864";"9143"
"São João do Rio do Peixe (PB)";"Total";"Total";"18201";"8940";"9261"
"Amparo (PB)";"Total";"Total";"2088";"1047";"1041"
"Aparecida (PB)";"Total";"Total";"7676";"3796";"3880"
"Araçagi (PB)";"Total";"Total";"17224";"8574";"8650"
"Arara (PB)";"Total";"Total";"12653";"6074";"6579"
"Araruna (PB)";"Total";"Total";"18879";"9324";"9555"
"Areia (PB)";"Total";"Total";"23829";"11669";"12160"
"Areia de Baraúnas (PB)";"Total";"Total";"1927";"963";"964"
"Areial (PB)";"Total";"Total";"6470";"3058";"3412"
"Aroeiras (PB)";"Total";"Total";"19082";"9222";"9860"
"Assunção (PB)";"Total";"Total";"3522";"1779";"1743"
"Baía da Traição (PB)";"Total";"Total";"8012";"4040";"3972"
"Bananeiras (PB)";"Total";"Total";"21851";"10784";"11067"
"Baraúna (PB)";"Total";"Total";"4220";"2110";"2110"
"Barra de Santana (PB)";"Total";"Total";"8206";"4147";"4059"
"Barra de Santa Rosa (PB)";"Total";"Total";"14157";"7085";"7072"
"Barra de São Miguel (PB)";"Total";"Total";"5611";"2918";"2693"
"Bayeux (PB)";"Total";"Total";"99716";"47736";"51980"
"Belém (PB)";"Total";"Total";"17093";"8345";"8748"
"Belém do Brejo do Cruz (PB)";"Total";"Total";"7143";"3607";"3536"
"Bernardino Batista (PB)";"Total";"Total";"3075";"1476";"1599"
"Boa Ventura (PB)";"Total";"Total";"5751";"2899";"2852"
"Boa Vista (PB)";"Total";"Total";"6227";"3085";"3142"
"Bom Jesus (PB)";"Total";"Total";"2400";"1219";"1181"
"Bom Sucesso (PB)";"Total";"Total";"5035";"2477";"2558"
"Bonito de Santa Fé (PB)";"Total";"Total";"10804";"5350";"5454"
"Boqueirão (PB)";"Total";"Total";"16888";"8323";"8565"
"Igaracy (PB)";"Total";"Total";"6156";"3019";"3137"
"Borborema (PB)";"Total";"Total";"5111";"2558";"2553"
"Brejo do Cruz (PB)";"Total";"Total";"13123";"6510";"6613"
"Brejo dos Santos (PB)";"Total";"Total";"6198";"3094";"3104"
"Caaporã (PB)";"Total";"Total";"20362";"10090";"10272"
"Cabaceiras (PB)";"Total";"Total";"5035";"2493";"2542"
"Cabedelo (PB)";"Total";"Total";"57944";"27630";"30314"
"Cachoeira dos Índios (PB)";"Total";"Total";"9546";"4820";"4726"
"Cacimba de Areia (PB)";"Total";"Total";"3557";"1779";"1778"
"Cacimba de Dentro (PB)";"Total";"Total";"16748";"8217";"8531"
"Cacimbas (PB)";"Total";"Total";"6814";"3284";"3530"
"Caiçara (PB)";"Total";"Total";"7220";"3619";"3601"
"Cajazeiras (PB)";"Total";"Total";"58446";"27938";"30508"
"Cajazeirinhas (PB)";"Total";"Total";"3033";"1548";"1485"
"Caldas Brandão (PB)";"Total";"Total";"5637";"2802";"2835"
"Camalaú (PB)";"Total";"Total";"5749";"2840";"2909"
"Campina Grande (PB)";"Total";"Total";"385213";"182205";"203008"
"Capim (PB)";"Total";"Total";"5601";"2815";"2786"
"Caraúbas (PB)";"Total";"Total";"3899";"1972";"1927"
"Carrapateira (PB)";"Total";"Total";"2378";"1247";"1131"
"Casserengue (PB)";"Total";"Total";"7058";"3549";"3509"
"Catingueira (PB)";"Total";"Total";"4812";"2413";"2399"
"Catolé do Rocha (PB)";"Total";"Total";"28759";"14028";"14731"
"Caturité (PB)";"Total";"Total";"4543";"2300";"2243"
"Conceição (PB)";"Total";"Total";"18363";"9120";"9243"
"Condado (PB)";"Total";"Total";"6584";"3215";"3369"
"Conde (PB)";"Total";"Total";"21400";"10763";"10637"
"Congo (PB)";"Total";"Total";"4687";"2378";"2309"
"Coremas (PB)";"Total";"Total";"15149";"7421";"7728"
"Coxixola (PB)";"Total";"Total";"1771";"916";"855"
"Cruz do Espírito Santo (PB)";"Total";"Total";"16257";"8093";"8164"
"Cubati (PB)";"Total";"Total";"6866";"3393";"3473"
"Cuité (PB)";"Total";"Total";"19978";"9833";"10145"
"Cuitegi (PB)";"Total";"Total";"6889";"3389";"3500"
"Cuité de Mamanguape (PB)";"Total";"Total";"6202";"3100";"3102"
"Curral de Cima (PB)";"Total";"Total";"5209";"2632";"2577"
"Curral Velho (PB)";"Total";"Total";"2505";"1304";"1201"
"Damião (PB)";"Total";"Total";"4900";"2460";"2440"
"Desterro (PB)";"Total";"Total";"7991";"3893";"4098"
"Vista Serrana (PB)";"Total";"Total";"3512";"1821";"1691"
"Diamante (PB)";"Total";"Total";"6616";"3331";"3285"
"Dona Inês (PB)";"Total";"Total";"10517";"5277";"5240"
"Duas Estradas (PB)";"Total";"Total";"3638";"1790";"1848"
"Emas (PB)";"Total";"Total";"3317";"1673";"1644"
"Esperança (PB)";"Total";"Total";"31095";"15155";"15940"
"Fagundes (PB)";"Total";"Total";"11405";"5607";"5798"
"Frei Martinho (PB)";"Total";"Total";"2933";"1468";"1465"
"Gado Bravo (PB)";"Total";"Total";"8376";"4133";"4243"
"Guarabira (PB)";"Total";"Total";"55326";"26693";"28633"
"Gurinhém (PB)";"Total";"Total";"13872";"6920";"6952"
"Gurjão (PB)";"Total";"Total";"3159";"1550";"1609"
"Ibiara (PB)";"Total";"Total";"6031";"3033";"2998"
"Imaculada (PB)";"Total";"Total";"11352";"5707";"5645"
"Ingá (PB)";"Total";"Total";"18180";"8838";"9342"
"Itabaiana (PB)";"Total";"Total";"24481";"11851";"12630"
"Itaporanga (PB)";"Total";"Total";"23192";"11389";"11803"
"Itapororoca (PB)";"Total";"Total";"16997";"8560";"8437"
"Itatuba (PB)";"Total";"Total";"10201";"5049";"5152"
"Jacaraú (PB)";"Total";"Total";"13942";"6918";"7024"
"Jericó (PB)";"Total";"Total";"7538";"3694";"3844"
"João Pessoa (PB)";"Total";"Total";"723515";"337783";"385732"
"Juarez Távora (PB)";"Total";"Total";"7459";"3641";"3818"
"Juazeirinho (PB)";"Total";"Total";"16776";"8366";"8410"
"Junco do Seridó (PB)";"Total";"Total";"6643";"3308";"3335"
"Juripiranga (PB)";"Total";"Total";"10237";"5129";"5108"
"Juru (PB)";"Total";"Total";"9826";"4897";"4929"
"Lagoa (PB)";"Total";"Total";"4681";"2304";"2377"
"Lagoa de Dentro (PB)";"Total";"Total";"7370";"3626";"3744"
"Lagoa Seca (PB)";"Total";"Total";"25900";"12743";"13157"
"Lastro (PB)";"Total";"Total";"2841";"1438";"1403"
"Livramento (PB)";"Total";"Total";"7164";"3524";"3640"
"Logradouro (PB)";"Total";"Total";"3942";"1938";"2004"
"Lucena (PB)";"Total";"Total";"11730";"5832";"5898"
"Mãe d'Água (PB)";"Total";"Total";"4019";"1964";"2055"
"Malta (PB)";"Total";"Total";"5613";"2703";"2910"
"Mamanguape (PB)";"Total";"Total";"42303";"20790";"21513"
"Manaíra (PB)";"Total";"Total";"10759";"5400";"5359"
"Marcação (PB)";"Total";"Total";"7609";"3894";"3715"
"Mari (PB)";"Total";"Total";"21176";"10367";"10809"
"Marizópolis (PB)";"Total";"Total";"6173";"3016";"3157"
"Massaranduba (PB)";"Total";"Total";"12902";"6245";"6657"
"Mataraca (PB)";"Total";"Total";"7407";"3690";"3717"
"Matinhas (PB)";"Total";"Total";"4321";"2151";"2170"
"Mato Grosso (PB)";"Total";"Total";"2702";"1349";"1353"
"Maturéia (PB)";"Total";"Total";"5939";"2900";"3039"
"Mogeiro (PB)";"Total";"Total";"12491";"6078";"6413"
"Montadas (PB)";"Total";"Total";"4990";"2482";"2508"
"Monte Horebe (PB)";"Total";"Total";"4508";"2262";"2246"
"Monteiro (PB)";"Total";"Total";"30852";"14985";"15867"
"Mulungu (PB)";"Total";"Total";"9469";"4630";"4839"
"Natuba (PB)";"Total";"Total";"10566";"5217";"5349"
"Nazarezinho (PB)";"Total";"Total";"7280";"3631";"3649"
"Nova Floresta (PB)";"Total";"Total";"10533";"5121";"5412"
"Nova Olinda (PB)";"Total";"Total";"6070";"3019";"3051"
"Nova Palmeira (PB)";"Total";"Total";"4361";"2163";"2198"
"Olho d'Água (PB)";"Total";"Total";"6931";"3352";"3579"
"Olivedos (PB)";"Total";"Total";"3627";"1853";"1774"
"Ouro Velho (PB)";"Total";"Total";"2928";"1470";"1458"
"Parari (PB)";"Total";"Total";"1256";"621";"635"
"Passagem (PB)";"Total";"Total";"2233";"1107";"1126"
"Patos (PB)";"Total";"Total";"100674";"47805";"52869"
"Paulista (PB)";"Total";"Total";"11788";"5829";"5959"
"Pedra Branca (PB)";"Total";"Total";"3721";"1847";"1874"
"Pedra Lavrada (PB)";"Total";"Total";"7475";"3734";"3741"
"Pedras de Fogo (PB)";"Total";"Total";"27032";"13467";"13565"
"Piancó (PB)";"Total";"Total";"15465";"7388";"8077"
"Picuí (PB)";"Total";"Total";"18222";"8953";"9269"
"Pilar (PB)";"Total";"Total";"11191";"5499";"5692"
"Pilões (PB)";"Total";"Total";"6978";"3517";"3461"
"Pilõezinhos (PB)";"Total";"Total";"5155";"2543";"2612"
"Pirpirituba (PB)";"Total";"Total";"10326";"5114";"5212"
"Pitimbu (PB)";"Total";"Total";"17024";"8609";"8415"
"Pocinhos (PB)";"Total";"Total";"17032";"8490";"8542"
"Poço Dantas (PB)";"Total";"Total";"3751";"1905";"1846"
"Poço de José de Moura (PB)";"Total";"Total";"3978";"1933";"2045"
"Pombal (PB)";"Total";"Total";"32110";"15381";"16729"
"Prata (PB)";"Total";"Total";"3854";"1926";"1928"
"Princesa Isabel (PB)";"Total";"Total";"21283";"10448";"10835"
"Puxinanã (PB)";"Total";"Total";"12923";"6356";"6567"
"Queimadas (PB)";"Total";"Total";"41049";"19936";"21113"
"Quixaba (PB)";"Total";"Total";"1699";"893";"806"
"Remígio (PB)";"Total";"Total";"17581";"8379";"9202"
"Pedro Régis (PB)";"Total";"Total";"5765";"2890";"2875"
"Riachão (PB)";"Total";"Total";"3266";"1602";"1664"
"Riachão do Bacamarte (PB)";"Total";"Total";"4264";"2082";"2182"
"Riachão do Poço (PB)";"Total";"Total";"4164";"2086";"2078"
"Riacho de Santo Antônio (PB)";"Total";"Total";"1722";"871";"851"
"Riacho dos Cavalos (PB)";"Total";"Total";"8314";"4242";"4072"
"Rio Tinto (PB)";"Total";"Total";"22976";"11310";"11666"
"Salgadinho (PB)";"Total";"Total";"3508";"1782";"1726"
"Salgado de São Félix (PB)";"Total";"Total";"11976";"5836";"6140"
"Santa Cecília (PB)";"Total";"Total";"6658";"3409";"3249"
"Santa Cruz (PB)";"Total";"Total";"6471";"3283";"3188"
"Santa Helena (PB)";"Total";"Total";"5369";"2626";"2743"
"Santa Inês (PB)";"Total";"Total";"3539";"1823";"1716"
"Santa Luzia (PB)";"Total";"Total";"14719";"7138";"7581"
"Santana de Mangueira (PB)";"Total";"Total";"5331";"2697";"2634"
"Santana dos Garrotes (PB)";"Total";"Total";"7266";"3512";"3754"
"Joca Claudino (PB)";"Total";"Total";"2615";"1268";"1347"
"Santa Rita (PB)";"Total";"Total";"120310";"58119";"62191"
"Santa Teresinha (PB)";"Total";"Total";"4581";"2276";"2305"
"Santo André (PB)";"Total";"Total";"2638";"1337";"1301"
"São Bento (PB)";"Total";"Total";"30879";"15220";"15659"
"São Bentinho (PB)";"Total";"Total";"4138";"2015";"2123"
"São Domingos do Cariri (PB)";"Total";"Total";"2420";"1212";"1208"
"São Domingos (PB)";"Total";"Total";"2855";"1412";"1443"
"São Francisco (PB)";"Total";"Total";"3364";"1660";"1704"
"São João do Cariri (PB)";"Total";"Total";"4344";"2120";"2224"
"São João do Tigre (PB)";"Total";"Total";"4396";"2247";"2149"
"São José da Lagoa Tapada (PB)";"Total";"Total";"7564";"3680";"3884"
"São José de Caiana (PB)";"Total";"Total";"6010";"3052";"2958"
"São José de Espinharas (PB)";"Total";"Total";"4760";"2501";"2259"
"São José dos Ramos (PB)";"Total";"Total";"5508";"2759";"2749"
"São José de Piranhas (PB)";"Total";"Total";"19096";"9529";"9567"
"São José de Princesa (PB)";"Total";"Total";"4219";"2139";"2080"
"São José do Bonfim (PB)";"Total";"Total";"3233";"1626";"1607"
"São José do Brejo do Cruz (PB)";"Total";"Total";"1684";"849";"835"
"São José do Sabugi (PB)";"Total";"Total";"4010";"2042";"1968"
"São José dos Cordeiros (PB)";"Total";"Total";"3985";"1982";"2003"
"São Mamede (PB)";"Total";"Total";"7748";"3837";"3911"
"São Miguel de Taipu (PB)";"Total";"Total";"6696";"3341";"3355"
"São Sebastião de Lagoa de Roça (PB)";"Total";"Total";"11041";"5423";"5618"
"São Sebastião do Umbuzeiro (PB)";"Total";"Total";"3235";"1616";"1619"
"Sapé (PB)";"Total";"Total";"50143";"24653";"25490"
"São Vicente do Seridó (PB)";"Total";"Total";"10230";"5261";"4969"
"Serra Branca (PB)";"Total";"Total";"12973";"6334";"6639"
"Serra da Raiz (PB)";"Total";"Total";"3204";"1595";"1609"
"Serra Grande (PB)";"Total";"Total";"2975";"1502";"1473"
"Serra Redonda (PB)";"Total";"Total";"7050";"3359";"3691"
"Serraria (PB)";"Total";"Total";"6238";"3092";"3146"
"Sertãozinho (PB)";"Total";"Total";"4395";"2143";"2252"
"Sobrado (PB)";"Total";"Total";"7373";"3679";"3694"
"Solânea (PB)";"Total";"Total";"26693";"12764";"13929"
"Soledade (PB)";"Total";"Total";"13739";"6770";"6969"
"Sossêgo (PB)";"Total";"Total";"3169";"1581";"1588"
"Sousa (PB)";"Total";"Total";"65803";"31798";"34005"
"Sumé (PB)";"Total";"Total";"16060";"7927";"8133"
"Tacima (PB)";"Total";"Total";"10262";"5162";"5100"
"Taperoá (PB)";"Total";"Total";"14936";"7346";"7590"
"Tavares (PB)";"Total";"Total";"14103";"7034";"7069"
"Teixeira (PB)";"Total";"Total";"14153";"6934";"7219"
"Tenório (PB)";"Total";"Total";"2813";"1466";"1347"
"Triunfo (PB)";"Total";"Total";"9220";"4570";"4650"
"Uiraúna (PB)";"Total";"Total";"14584";"7011";"7573"
"Umbuzeiro (PB)";"Total";"Total";"9298";"4509";"4789"
"Várzea (PB)";"Total";"Total";"2504";"1268";"1236"
"Vieirópolis (PB)";"Total";"Total";"5045";"2538";"2507"
"Zabelê (PB)";"Total";"Total";"2075";"1051";"1024"
"Abreu e Lima (PE)";"Total";"Total";"94429";"45125";"49304"
"Afogados da Ingazeira (PE)";"Total";"Total";"35088";"16790";"18298"
"Afrânio (PE)";"Total";"Total";"17586";"8750";"8836"
"Agrestina (PE)";"Total";"Total";"22679";"10935";"11744"
"Água Preta (PE)";"Total";"Total";"33095";"16610";"16485"
"Águas Belas (PE)";"Total";"Total";"40235";"19666";"20569"
"Alagoinha (PE)";"Total";"Total";"13759";"6913";"6846"
"Aliança (PE)";"Total";"Total";"37415";"18579";"18836"
"Altinho (PE)";"Total";"Total";"22353";"11106";"11247"
"Amaraji (PE)";"Total";"Total";"21939";"10984";"10955"
"Angelim (PE)";"Total";"Total";"10202";"5018";"5184"
"Araçoiaba (PE)";"Total";"Total";"18156";"9027";"9129"
"Araripina (PE)";"Total";"Total";"77302";"37836";"39466"
"Arcoverde (PE)";"Total";"Total";"68793";"32369";"36424"
"Barra de Guabiraba (PE)";"Total";"Total";"12776";"6515";"6261"
"Barreiros (PE)";"Total";"Total";"40732";"19885";"20847"
"Belém de Maria (PE)";"Total";"Total";"11353";"5635";"5718"
"Belém do São Francisco (PE)";"Total";"Total";"20253";"9960";"10293"
"Belo Jardim (PE)";"Total";"Total";"72432";"34780";"37652"
"Betânia (PE)";"Total";"Total";"12003";"6008";"5995"
"Bezerros (PE)";"Total";"Total";"58668";"28050";"30618"
"Bodocó (PE)";"Total";"Total";"35158";"17621";"17537"
"Bom Conselho (PE)";"Total";"Total";"45503";"22004";"23499"
"Bom Jardim (PE)";"Total";"Total";"37826";"18477";"19349"
"Bonito (PE)";"Total";"Total";"37566";"18577";"18989"
"Brejão (PE)";"Total";"Total";"8844";"4334";"4510"
"Brejinho (PE)";"Total";"Total";"7307";"3608";"3699"
"Brejo da Madre de Deus (PE)";"Total";"Total";"45180";"22180";"23000"
"Buenos Aires (PE)";"Total";"Total";"12537";"6197";"6340"
"Buíque (PE)";"Total";"Total";"52105";"25641";"26464"
"Cabo de Santo Agostinho (PE)";"Total";"Total";"185025";"90859";"94166"
"Cabrobó (PE)";"Total";"Total";"30873";"15052";"15821"
"Cachoeirinha (PE)";"Total";"Total";"18819";"9104";"9715"
"Caetés (PE)";"Total";"Total";"26577";"13172";"13405"
"Calçado (PE)";"Total";"Total";"11125";"5566";"5559"
"Calumbi (PE)";"Total";"Total";"5648";"2722";"2926"
"Camaragibe (PE)";"Total";"Total";"144466";"69212";"75254"
"Camocim de São Félix (PE)";"Total";"Total";"17104";"8322";"8782"
"Camutanga (PE)";"Total";"Total";"8156";"4086";"4070"
"Canhotinho (PE)";"Total";"Total";"24521";"12365";"12156"
"Capoeiras (PE)";"Total";"Total";"19593";"9772";"9821"
"Carnaíba (PE)";"Total";"Total";"18574";"9166";"9408"
"Carnaubeira da Penha (PE)";"Total";"Total";"11782";"5989";"5793"
"Carpina (PE)";"Total";"Total";"74858";"35563";"39295"
"Caruaru (PE)";"Total";"Total";"314912";"149153";"165759"
"Casinhas (PE)";"Total";"Total";"13766";"6799";"6967"
"Catende (PE)";"Total";"Total";"37820";"18303";"19517"
"Cedro (PE)";"Total";"Total";"10778";"5391";"5387"
"Chã de Alegria (PE)";"Total";"Total";"12404";"6096";"6308"
"Chã Grande (PE)";"Total";"Total";"20137";"9982";"10155"
"Condado (PE)";"Total";"Total";"24282";"11844";"12438"
"Correntes (PE)";"Total";"Total";"17419";"8610";"8809"
"Cortês (PE)";"Total";"Total";"12452";"6183";"6269"
"Cumaru (PE)";"Total";"Total";"17183";"8508";"8675"
"Cupira (PE)";"Total";"Total";"23390";"11050";"12340"
"Custódia (PE)";"Total";"Total";"33855";"16652";"17203"
"Dormentes (PE)";"Total";"Total";"16917";"8657";"8260"
"Escada (PE)";"Total";"Total";"63517";"31151";"32366"
"Exu (PE)";"Total";"Total";"31636";"15485";"16151"
"Feira Nova (PE)";"Total";"Total";"20571";"9972";"10599"
"Fernando de Noronha (PE)";"Total";"Total";"2630";"1292";"1338"
"Ferreiros (PE)";"Total";"Total";"11430";"5642";"5788"
"Flores (PE)";"Total";"Total";"22169";"10938";"11231"
"Floresta (PE)";"Total";"Total";"29285";"14431";"14854"
"Frei Miguelinho (PE)";"Total";"Total";"14293";"6998";"7295"
"Gameleira (PE)";"Total";"Total";"27912";"14102";"13810"
"Garanhuns (PE)";"Total";"Total";"129408";"60976";"68432"
"Glória do Goitá (PE)";"Total";"Total";"29019";"14166";"14853"
"Goiana (PE)";"Total";"Total";"75644";"36644";"39000"
"Granito (PE)";"Total";"Total";"6855";"3451";"3404"
"Gravatá (PE)";"Total";"Total";"76458";"36904";"39554"
"Iati (PE)";"Total";"Total";"18360";"9180";"9180"
"Ibimirim (PE)";"Total";"Total";"26954";"13350";"13604"
"Ibirajuba (PE)";"Total";"Total";"7534";"3791";"3743"
"Igarassu (PE)";"Total";"Total";"102021";"49316";"52705"
"Iguaracy (PE)";"Total";"Total";"11779";"5915";"5864"
"Inajá (PE)";"Total";"Total";"19081";"9555";"9526"
"Ingazeira (PE)";"Total";"Total";"4496";"2290";"2206"
"Ipojuca (PE)";"Total";"Total";"80637";"39890";"40747"
"Ipubi (PE)";"Total";"Total";"28120";"13855";"14265"
"Itacuruba (PE)";"Total";"Total";"4369";"2135";"2234"
"Itaíba (PE)";"Total";"Total";"26256";"13042";"13214"
"Ilha de Itamaracá (PE)";"Total";"Total";"21884";"12564";"9320"
"Itambé (PE)";"Total";"Total";"35398";"17484";"17914"
"Itapetim (PE)";"Total";"Total";"13881";"6850";"7031"
"Itapissuma (PE)";"Total";"Total";"23769";"12007";"11762"
"Itaquitinga (PE)";"Total";"Total";"15692";"7882";"7810"
"Jaboatão dos Guararapes (PE)";"Total";"Total";"644620";"304850";"339770"
"Jaqueira (PE)";"Total";"Total";"11501";"5705";"5796"
"Jataúba (PE)";"Total";"Total";"15819";"7860";"7959"
"Jatobá (PE)";"Total";"Total";"13963";"6837";"7126"
"João Alfredo (PE)";"Total";"Total";"30743";"14870";"15873"
"Joaquim Nabuco (PE)";"Total";"Total";"15773";"7900";"7873"
"Jucati (PE)";"Total";"Total";"10604";"5272";"5332"
"Jupi (PE)";"Total";"Total";"13705";"6683";"7022"
"Jurema (PE)";"Total";"Total";"14541";"7133";"7408"
"Lagoa do Carro (PE)";"Total";"Total";"16007";"7854";"8153"
"Lagoa de Itaenga (PE)";"Total";"Total";"20659";"10070";"10589"
"Lagoa do Ouro (PE)";"Total";"Total";"12132";"5970";"6162"
"Lagoa dos Gatos (PE)";"Total";"Total";"15615";"7825";"7790"
"Lagoa Grande (PE)";"Total";"Total";"22760";"11317";"11443"
"Lajedo (PE)";"Total";"Total";"36628";"17418";"19210"
"Limoeiro (PE)";"Total";"Total";"55439";"26826";"28613"
"Macaparana (PE)";"Total";"Total";"23925";"11666";"12259"
"Machados (PE)";"Total";"Total";"13596";"6551";"7045"
"Manari (PE)";"Total";"Total";"18083";"9128";"8955"
"Maraial (PE)";"Total";"Total";"12230";"6170";"6060"
"Mirandiba (PE)";"Total";"Total";"14308";"7116";"7192"
"Moreno (PE)";"Total";"Total";"56696";"27664";"29032"
"Nazaré da Mata (PE)";"Total";"Total";"30796";"14747";"16049"
"Olinda (PE)";"Total";"Total";"377779";"174724";"203055"
"Orobó (PE)";"Total";"Total";"22878";"11067";"11811"
"Orocó (PE)";"Total";"Total";"13180";"6571";"6609"
"Ouricuri (PE)";"Total";"Total";"64358";"31699";"32659"
"Palmares (PE)";"Total";"Total";"59526";"28803";"30723"
"Palmeirina (PE)";"Total";"Total";"8189";"3986";"4203"
"Panelas (PE)";"Total";"Total";"25645";"12588";"13057"
"Paranatama (PE)";"Total";"Total";"11001";"5518";"5483"
"Parnamirim (PE)";"Total";"Total";"20224";"10280";"9944"
"Passira (PE)";"Total";"Total";"28628";"13980";"14648"
"Paudalho (PE)";"Total";"Total";"51357";"25205";"26152"
"Paulista (PE)";"Total";"Total";"300466";"141630";"158836"
"Pedra (PE)";"Total";"Total";"20944";"10473";"10471"
"Pesqueira (PE)";"Total";"Total";"62931";"30615";"32316"
"Petrolândia (PE)";"Total";"Total";"32492";"15947";"16545"
"Petrolina (PE)";"Total";"Total";"293962";"143252";"150710"
"Poção (PE)";"Total";"Total";"11242";"5375";"5867"
"Pombos (PE)";"Total";"Total";"24046";"11882";"12164"
"Primavera (PE)";"Total";"Total";"13439";"6882";"6557"
"Quipapá (PE)";"Total";"Total";"24186";"11918";"12268"
"Quixaba (PE)";"Total";"Total";"6739";"3325";"3414"
"Recife (PE)";"Total";"Total";"1537704";"709819";"827885"
"Riacho das Almas (PE)";"Total";"Total";"19162";"9417";"9745"
"Ribeirão (PE)";"Total";"Total";"44439";"21734";"22705"
"Rio Formoso (PE)";"Total";"Total";"22151";"11127";"11024"
"Sairé (PE)";"Total";"Total";"11240";"5534";"5706"
"Salgadinho (PE)";"Total";"Total";"9312";"4679";"4633"
"Salgueiro (PE)";"Total";"Total";"56629";"27604";"29025"
"Saloá (PE)";"Total";"Total";"15309";"7383";"7926"
"Sanharó (PE)";"Total";"Total";"21955";"10760";"11195"
"Santa Cruz (PE)";"Total";"Total";"13594";"6810";"6784"
"Santa Cruz da Baixa Verde (PE)";"Total";"Total";"11768";"5812";"5956"
"Santa Cruz do Capibaribe (PE)";"Total";"Total";"87582";"42373";"45209"
"Santa Filomena (PE)";"Total";"Total";"13371";"6759";"6612"
"Santa Maria da Boa Vista (PE)";"Total";"Total";"39435";"19868";"19567"
"Santa Maria do Cambucá (PE)";"Total";"Total";"13021";"6474";"6547"
"Santa Terezinha (PE)";"Total";"Total";"10991";"5385";"5606"
"São Benedito do Sul (PE)";"Total";"Total";"13941";"7017";"6924"
"São Bento do Una (PE)";"Total";"Total";"53242";"26564";"26678"
"São Caitano (PE)";"Total";"Total";"35274";"17203";"18071"
"São João (PE)";"Total";"Total";"21312";"10441";"10871"
"São Joaquim do Monte (PE)";"Total";"Total";"20488";"10195";"10293"
"São José da Coroa Grande (PE)";"Total";"Total";"18180";"8867";"9313"
"São José do Belmonte (PE)";"Total";"Total";"32617";"16241";"16376"
"São José do Egito (PE)";"Total";"Total";"31829";"15518";"16311"
"São Lourenço da Mata (PE)";"Total";"Total";"102895";"50016";"52879"
"São Vicente Férrer (PE)";"Total";"Total";"17000";"8369";"8631"
"Serra Talhada (PE)";"Total";"Total";"79232";"37827";"41405"
"Serrita (PE)";"Total";"Total";"18331";"9199";"9132"
"Sertânia (PE)";"Total";"Total";"33787";"16500";"17287"
"Sirinhaém (PE)";"Total";"Total";"40296";"20348";"19948"
"Moreilândia (PE)";"Total";"Total";"11132";"5591";"5541"
"Solidão (PE)";"Total";"Total";"5744";"2902";"2842"
"Surubim (PE)";"Total";"Total";"58515";"27994";"30521"
"Tabira (PE)";"Total";"Total";"26427";"12967";"13460"
"Tacaimbó (PE)";"Total";"Total";"12725";"6256";"6469"
"Tacaratu (PE)";"Total";"Total";"22068";"11159";"10909"
"Tamandaré (PE)";"Total";"Total";"20715";"10410";"10305"
"Taquaritinga do Norte (PE)";"Total";"Total";"24903";"12332";"12571"
"Terezinha (PE)";"Total";"Total";"6737";"3271";"3466"
"Terra Nova (PE)";"Total";"Total";"9278";"4723";"4555"
"Timbaúba (PE)";"Total";"Total";"53825";"25904";"27921"
"Toritama (PE)";"Total";"Total";"35554";"17421";"18133"
"Tracunhaém (PE)";"Total";"Total";"13055";"6363";"6692"
"Trindade (PE)";"Total";"Total";"26116";"12896";"13220"
"Triunfo (PE)";"Total";"Total";"15006";"7180";"7826"
"Tupanatinga (PE)";"Total";"Total";"24425";"12115";"12310"
"Tuparetama (PE)";"Total";"Total";"7925";"3852";"4073"
"Venturosa (PE)";"Total";"Total";"16052";"7860";"8192"
"Verdejante (PE)";"Total";"Total";"9142";"4484";"4658"
"Vertente do Lério (PE)";"Total";"Total";"7873";"3867";"4006"
"Vertentes (PE)";"Total";"Total";"18222";"8936";"9286"
"Vicência (PE)";"Total";"Total";"30732";"15183";"15549"
"Vitória de Santo Antão (PE)";"Total";"Total";"129974";"62409";"67565"
"Xexéu (PE)";"Total";"Total";"14093";"6995";"7098"
"Água Branca (AL)";"Total";"Total";"19377";"9655";"9722"
"Anadia (AL)";"Total";"Total";"17424";"8569";"8855"
"Arapiraca (AL)";"Total";"Total";"214006";"101884";"112122"
"Atalaia (AL)";"Total";"Total";"44322";"22209";"22113"
"Barra de Santo Antônio (AL)";"Total";"Total";"14230";"7077";"7153"
"Barra de São Miguel (AL)";"Total";"Total";"7574";"3763";"3811"
"Batalha (AL)";"Total";"Total";"17076";"8386";"8690"
"Belém (AL)";"Total";"Total";"4551";"2222";"2329"
"Belo Monte (AL)";"Total";"Total";"7030";"3550";"3480"
"Boca da Mata (AL)";"Total";"Total";"25776";"12769";"13007"
"Branquinha (AL)";"Total";"Total";"10583";"5379";"5204"
"Cacimbinhas (AL)";"Total";"Total";"10195";"5048";"5147"
"Cajueiro (AL)";"Total";"Total";"20409";"10078";"10331"
"Campestre (AL)";"Total";"Total";"6598";"3288";"3310"
"Campo Alegre (AL)";"Total";"Total";"50816";"25025";"25791"
"Campo Grande (AL)";"Total";"Total";"9032";"4437";"4595"
"Canapi (AL)";"Total";"Total";"17250";"8662";"8588"
"Capela (AL)";"Total";"Total";"17077";"8430";"8647"
"Carneiros (AL)";"Total";"Total";"8290";"4058";"4232"
"Chã Preta (AL)";"Total";"Total";"7146";"3644";"3502"
"Coité do Nóia (AL)";"Total";"Total";"10926";"5422";"5504"
"Colônia Leopoldina (AL)";"Total";"Total";"20019";"10073";"9946"
"Coqueiro Seco (AL)";"Total";"Total";"5526";"2756";"2770"
"Coruripe (AL)";"Total";"Total";"52130";"25748";"26382"
"Craíbas (AL)";"Total";"Total";"22641";"11157";"11484"
"Delmiro Gouveia (AL)";"Total";"Total";"48096";"23052";"25044"
"Dois Riachos (AL)";"Total";"Total";"10880";"5454";"5426"
"Estrela de Alagoas (AL)";"Total";"Total";"17251";"8404";"8847"
"Feira Grande (AL)";"Total";"Total";"21321";"10561";"10760"
"Feliz Deserto (AL)";"Total";"Total";"4345";"2131";"2214"
"Flexeiras (AL)";"Total";"Total";"12325";"6232";"6093"
"Girau do Ponciano (AL)";"Total";"Total";"36600";"18165";"18435"
"Ibateguara (AL)";"Total";"Total";"15149";"7573";"7576"
"Igaci (AL)";"Total";"Total";"25188";"12270";"12918"
"Igreja Nova (AL)";"Total";"Total";"23292";"11747";"11545"
"Inhapi (AL)";"Total";"Total";"17898";"8811";"9087"
"Jacaré dos Homens (AL)";"Total";"Total";"5413";"2671";"2742"
"Jacuípe (AL)";"Total";"Total";"6997";"3587";"3410"
"Japaratinga (AL)";"Total";"Total";"7754";"3874";"3880"
"Jaramataia (AL)";"Total";"Total";"5558";"2805";"2753"
"Jequiá da Praia (AL)";"Total";"Total";"12029";"6128";"5901"
"Joaquim Gomes (AL)";"Total";"Total";"22575";"11520";"11055"
"Jundiá (AL)";"Total";"Total";"4202";"2126";"2076"
"Junqueiro (AL)";"Total";"Total";"23836";"11743";"12093"
"Lagoa da Canoa (AL)";"Total";"Total";"18250";"8971";"9279"
"Limoeiro de Anadia (AL)";"Total";"Total";"26992";"13424";"13568"
"Maceió (AL)";"Total";"Total";"932748";"436492";"496256"
"Major Isidoro (AL)";"Total";"Total";"18897";"9268";"9629"
"Maragogi (AL)";"Total";"Total";"28749";"14516";"14233"
"Maravilha (AL)";"Total";"Total";"10284";"5197";"5087"
"Marechal Deodoro (AL)";"Total";"Total";"45977";"22709";"23268"
"Maribondo (AL)";"Total";"Total";"13619";"6537";"7082"
"Mar Vermelho (AL)";"Total";"Total";"3652";"1821";"1831"
"Mata Grande (AL)";"Total";"Total";"24698";"12332";"12366"
"Matriz de Camaragibe (AL)";"Total";"Total";"23785";"11597";"12188"
"Messias (AL)";"Total";"Total";"15682";"7703";"7979"
"Minador do Negrão (AL)";"Total";"Total";"5275";"2616";"2659"
"Monteirópolis (AL)";"Total";"Total";"6935";"3358";"3577"
"Murici (AL)";"Total";"Total";"26710";"13278";"13432"
"Novo Lino (AL)";"Total";"Total";"12060";"6120";"5940"
"Olho d'Água das Flores (AL)";"Total";"Total";"20364";"9722";"10642"
"Olho d'Água do Casado (AL)";"Total";"Total";"8491";"4278";"4213"
"Olho d'Água Grande (AL)";"Total";"Total";"4957";"2463";"2494"
"Olivença (AL)";"Total";"Total";"11047";"5561";"5486"
"Ouro Branco (AL)";"Total";"Total";"10912";"5437";"5475"
"Palestina (AL)";"Total";"Total";"5112";"2474";"2638"
"Palmeira dos Índios (AL)";"Total";"Total";"70368";"33582";"36786"
"Pão de Açúcar (AL)";"Total";"Total";"23811";"11758";"12053"
"Pariconha (AL)";"Total";"Total";"10264";"5114";"5150"
"Paripueira (AL)";"Total";"Total";"11347";"5590";"5757"
"Passo de Camaragibe (AL)";"Total";"Total";"14763";"7512";"7251"
"Paulo Jacinto (AL)";"Total";"Total";"7426";"3631";"3795"
"Penedo (AL)";"Total";"Total";"60378";"29308";"31070"
"Piaçabuçu (AL)";"Total";"Total";"17203";"8615";"8588"
"Pilar (AL)";"Total";"Total";"33305";"16167";"17138"
"Pindoba (AL)";"Total";"Total";"2866";"1420";"1446"
"Piranhas (AL)";"Total";"Total";"23045";"11294";"11751"
"Poço das Trincheiras (AL)";"Total";"Total";"13872";"7002";"6870"
"Porto Calvo (AL)";"Total";"Total";"25708";"12754";"12954"
"Porto de Pedras (AL)";"Total";"Total";"8429";"4270";"4159"
"Porto Real do Colégio (AL)";"Total";"Total";"19334";"9594";"9740"
"Quebrangulo (AL)";"Total";"Total";"11480";"5671";"5809"
"Rio Largo (AL)";"Total";"Total";"68481";"33301";"35180"
"Roteiro (AL)";"Total";"Total";"6656";"3369";"3287"
"Santa Luzia do Norte (AL)";"Total";"Total";"6891";"3370";"3521"
"Santana do Ipanema (AL)";"Total";"Total";"44932";"21811";"23121"
"Santana do Mundaú (AL)";"Total";"Total";"10961";"5490";"5471"
"São Brás (AL)";"Total";"Total";"6718";"3334";"3384"
"São José da Laje (AL)";"Total";"Total";"22686";"11172";"11514"
"São José da Tapera (AL)";"Total";"Total";"30088";"14850";"15238"
"São Luís do Quitunde (AL)";"Total";"Total";"32412";"16328";"16084"
"São Miguel dos Campos (AL)";"Total";"Total";"54577";"26565";"28012"
"São Miguel dos Milagres (AL)";"Total";"Total";"7163";"3563";"3600"
"São Sebastião (AL)";"Total";"Total";"32010";"15851";"16159"
"Satuba (AL)";"Total";"Total";"14603";"7106";"7497"
"Senador Rui Palmeira (AL)";"Total";"Total";"13047";"6405";"6642"
"Tanque d'Arca (AL)";"Total";"Total";"6122";"3020";"3102"
"Taquarana (AL)";"Total";"Total";"19020";"9237";"9783"
"Teotônio Vilela (AL)";"Total";"Total";"41152";"20164";"20988"
"Traipu (AL)";"Total";"Total";"25702";"12951";"12751"
"União dos Palmares (AL)";"Total";"Total";"62358";"30171";"32187"
"Viçosa (AL)";"Total";"Total";"25407";"12410";"12997"
"Amparo do São Francisco (SE)";"Total";"Total";"2275";"1135";"1140"
"Aquidabã (SE)";"Total";"Total";"20056";"9805";"10251"
"Aracaju (SE)";"Total";"Total";"571149";"265484";"305665"
"Arauá (SE)";"Total";"Total";"10878";"5487";"5391"
"Areia Branca (SE)";"Total";"Total";"16857";"8493";"8364"
"Barra dos Coqueiros (SE)";"Total";"Total";"24976";"12212";"12764"
"Boquim (SE)";"Total";"Total";"25533";"12538";"12995"
"Brejo Grande (SE)";"Total";"Total";"7742";"3936";"3806"
"Campo do Brito (SE)";"Total";"Total";"16749";"8233";"8516"
"Canhoba (SE)";"Total";"Total";"3956";"2061";"1895"
"Canindé de São Francisco (SE)";"Total";"Total";"24686";"12293";"12393"
"Capela (SE)";"Total";"Total";"30761";"15269";"15492"
"Carira (SE)";"Total";"Total";"20007";"9970";"10037"
"Carmópolis (SE)";"Total";"Total";"13503";"6671";"6832"
"Cedro de São João (SE)";"Total";"Total";"5633";"2780";"2853"
"Cristinápolis (SE)";"Total";"Total";"16519";"8295";"8224"
"Cumbe (SE)";"Total";"Total";"3813";"1903";"1910"
"Divina Pastora (SE)";"Total";"Total";"4326";"2189";"2137"
"Estância (SE)";"Total";"Total";"64409";"31365";"33044"
"Feira Nova (SE)";"Total";"Total";"5324";"2630";"2694"
"Frei Paulo (SE)";"Total";"Total";"13874";"6785";"7089"
"Gararu (SE)";"Total";"Total";"11405";"5811";"5594"
"General Maynard (SE)";"Total";"Total";"2929";"1423";"1506"
"Gracho Cardoso (SE)";"Total";"Total";"5645";"2889";"2756"
"Ilha das Flores (SE)";"Total";"Total";"8348";"4168";"4180"
"Indiaroba (SE)";"Total";"Total";"15831";"8027";"7804"
"Itabaiana (SE)";"Total";"Total";"86967";"42496";"44471"
"Itabaianinha (SE)";"Total";"Total";"38910";"19379";"19531"
"Itabi (SE)";"Total";"Total";"4972";"2478";"2494"
"Itaporanga d'Ajuda (SE)";"Total";"Total";"30419";"15165";"15254"
"Japaratuba (SE)";"Total";"Total";"16864";"8389";"8475"
"Japoatã (SE)";"Total";"Total";"12938";"6482";"6456"
"Lagarto (SE)";"Total";"Total";"94861";"46489";"48372"
"Laranjeiras (SE)";"Total";"Total";"26902";"13131";"13771"
"Macambira (SE)";"Total";"Total";"6401";"3162";"3239"
"Malhada dos Bois (SE)";"Total";"Total";"3456";"1753";"1703"
"Malhador (SE)";"Total";"Total";"12042";"6081";"5961"
"Maruim (SE)";"Total";"Total";"16343";"8011";"8332"
"Moita Bonita (SE)";"Total";"Total";"11001";"5462";"5539"
"Monte Alegre de Sergipe (SE)";"Total";"Total";"13627";"6900";"6727"
"Muribeca (SE)";"Total";"Total";"7344";"3685";"3659"
"Neópolis (SE)";"Total";"Total";"18506";"9233";"9273"
"Nossa Senhora Aparecida (SE)";"Total";"Total";"8508";"4257";"4251"
"Nossa Senhora da Glória (SE)";"Total";"Total";"32497";"16076";"16421"
"Nossa Senhora das Dores (SE)";"Total";"Total";"24580";"12127";"12453"
"Nossa Senhora de Lourdes (SE)";"Total";"Total";"6238";"3151";"3087"
"Nossa Senhora do Socorro (SE)";"Total";"Total";"160827";"78287";"82540"
"Pacatuba (SE)";"Total";"Total";"13137";"6687";"6450"
"Pedra Mole (SE)";"Total";"Total";"2974";"1496";"1478"
"Pedrinhas (SE)";"Total";"Total";"8833";"4356";"4477"
"Pinhão (SE)";"Total";"Total";"5973";"2926";"3047"
"Pirambu (SE)";"Total";"Total";"8369";"4213";"4156"
"Poço Redondo (SE)";"Total";"Total";"30880";"15767";"15113"
"Poço Verde (SE)";"Total";"Total";"21983";"10866";"11117"
"Porto da Folha (SE)";"Total";"Total";"27146";"13883";"13263"
"Propriá (SE)";"Total";"Total";"28451";"13846";"14605"
"Riachão do Dantas (SE)";"Total";"Total";"19386";"9736";"9650"
"Riachuelo (SE)";"Total";"Total";"9355";"4554";"4801"
"Ribeirópolis (SE)";"Total";"Total";"17173";"8492";"8681"
"Rosário do Catete (SE)";"Total";"Total";"9221";"4439";"4782"
"Salgado (SE)";"Total";"Total";"19365";"9658";"9707"
"Santa Luzia do Itanhy (SE)";"Total";"Total";"12969";"6654";"6315"
"Santana do São Francisco (SE)";"Total";"Total";"7038";"3537";"3501"
"Santa Rosa de Lima (SE)";"Total";"Total";"3749";"1887";"1862"
"Santo Amaro das Brotas (SE)";"Total";"Total";"11410";"5612";"5798"
"São Cristóvão (SE)";"Total";"Total";"78864";"38399";"40465"
"São Domingos (SE)";"Total";"Total";"10271";"5091";"5180"
"São Francisco (SE)";"Total";"Total";"3393";"1708";"1685"
"São Miguel do Aleixo (SE)";"Total";"Total";"3698";"1840";"1858"
"Simão Dias (SE)";"Total";"Total";"38702";"18888";"19814"
"Siriri (SE)";"Total";"Total";"8004";"3989";"4015"
"Telha (SE)";"Total";"Total";"2957";"1476";"1481"
"Tobias Barreto (SE)";"Total";"Total";"48040";"23459";"24581"
"Tomar do Geru (SE)";"Total";"Total";"12855";"6536";"6319"
"Umbaúba (SE)";"Total";"Total";"22434";"11000";"11434"
"Abaíra (BA)";"Total";"Total";"8316";"4082";"4234"
"Abaré (BA)";"Total";"Total";"17064";"8564";"8500"
"Acajutiba (BA)";"Total";"Total";"14653";"7208";"7445"
"Adustina (BA)";"Total";"Total";"15702";"7907";"7795"
"Água Fria (BA)";"Total";"Total";"15731";"7903";"7828"
"Érico Cardoso (BA)";"Total";"Total";"10859";"5422";"5437"
"Aiquara (BA)";"Total";"Total";"4602";"2351";"2251"
"Alagoinhas (BA)";"Total";"Total";"141949";"67212";"74737"
"Alcobaça (BA)";"Total";"Total";"21271";"10815";"10456"
"Almadina (BA)";"Total";"Total";"6357";"3200";"3157"
"Amargosa (BA)";"Total";"Total";"34351";"16647";"17704"
"Amélia Rodrigues (BA)";"Total";"Total";"25190";"12283";"12907"
"América Dourada (BA)";"Total";"Total";"15961";"8073";"7888"
"Anagé (BA)";"Total";"Total";"25516";"12892";"12624"
"Andaraí (BA)";"Total";"Total";"13960";"7181";"6779"
"Andorinha (BA)";"Total";"Total";"14414";"7328";"7086"
"Angical (BA)";"Total";"Total";"14073";"7460";"6613"
"Anguera (BA)";"Total";"Total";"10242";"5083";"5159"
"Antas (BA)";"Total";"Total";"17072";"8581";"8491"
"Antônio Cardoso (BA)";"Total";"Total";"11554";"5734";"5820"
"Antônio Gonçalves (BA)";"Total";"Total";"11015";"5573";"5442"
"Aporá (BA)";"Total";"Total";"17731";"8961";"8770"
"Apuarema (BA)";"Total";"Total";"7459";"3794";"3665"
"Aracatu (BA)";"Total";"Total";"13743";"7052";"6691"
"Araçás (BA)";"Total";"Total";"11561";"5828";"5733"
"Araci (BA)";"Total";"Total";"51651";"25940";"25711"
"Aramari (BA)";"Total";"Total";"10036";"4999";"5037"
"Arataca (BA)";"Total";"Total";"10392";"5502";"4890"
"Aratuípe (BA)";"Total";"Total";"8599";"4376";"4223"
"Aurelino Leal (BA)";"Total";"Total";"13595";"6833";"6762"
"Baianópolis (BA)";"Total";"Total";"13850";"7162";"6688"
"Baixa Grande (BA)";"Total";"Total";"20060";"9966";"10094"
"Banzaê (BA)";"Total";"Total";"11814";"5993";"5821"
"Barra (BA)";"Total";"Total";"49325";"25160";"24165"
"Barra da Estiva (BA)";"Total";"Total";"21187";"10648";"10539"
"Barra do Choça (BA)";"Total";"Total";"34788";"17553";"17235"
"Barra do Mendes (BA)";"Total";"Total";"13987";"7012";"6975"
"Barra do Rocha (BA)";"Total";"Total";"6313";"3337";"2976"
"Barreiras (BA)";"Total";"Total";"137427";"67913";"69514"
"Barro Alto (BA)";"Total";"Total";"13612";"6909";"6703"
"Barrocas (BA)";"Total";"Total";"14191";"7218";"6973"
"Barro Preto (BA)";"Total";"Total";"6453";"3306";"3147"
"Belmonte (BA)";"Total";"Total";"21798";"11159";"10639"
"Belo Campo (BA)";"Total";"Total";"16021";"8120";"7901"
"Biritinga (BA)";"Total";"Total";"14836";"7553";"7283"
"Boa Nova (BA)";"Total";"Total";"15411";"7824";"7587"
"Boa Vista do Tupim (BA)";"Total";"Total";"17991";"9134";"8857"
"Bom Jesus da Lapa (BA)";"Total";"Total";"63480";"31676";"31804"
"Bom Jesus da Serra (BA)";"Total";"Total";"10113";"5191";"4922"
"Boninal (BA)";"Total";"Total";"13695";"6702";"6993"
"Bonito (BA)";"Total";"Total";"14834";"7521";"7313"
"Boquira (BA)";"Total";"Total";"22037";"10856";"11181"
"Botuporã (BA)";"Total";"Total";"11154";"5608";"5546"
"Brejões (BA)";"Total";"Total";"14282";"7114";"7168"
"Brejolândia (BA)";"Total";"Total";"11077";"5798";"5279"
"Brotas de Macaúbas (BA)";"Total";"Total";"10717";"5472";"5245"
"Brumado (BA)";"Total";"Total";"64602";"31747";"32855"
"Buerarema (BA)";"Total";"Total";"18605";"9307";"9298"
"Buritirama (BA)";"Total";"Total";"19600";"10202";"9398"
"Caatiba (BA)";"Total";"Total";"11420";"5992";"5428"
"Cabaceiras do Paraguaçu (BA)";"Total";"Total";"17327";"8549";"8778"
"Cachoeira (BA)";"Total";"Total";"32026";"15453";"16573"
"Caculé (BA)";"Total";"Total";"22236";"11137";"11099"
"Caém (BA)";"Total";"Total";"10368";"5140";"5228"
"Caetanos (BA)";"Total";"Total";"13639";"7054";"6585"
"Caetité (BA)";"Total";"Total";"47515";"23419";"24096"
"Cafarnaum (BA)";"Total";"Total";"17209";"8764";"8445"
"Cairu (BA)";"Total";"Total";"15374";"7841";"7533"
"Caldeirão Grande (BA)";"Total";"Total";"12491";"6152";"6339"
"Camacan (BA)";"Total";"Total";"31472";"15734";"15738"
"Camaçari (BA)";"Total";"Total";"242970";"120704";"122266"
"Camamu (BA)";"Total";"Total";"35180";"17899";"17281"
"Campo Alegre de Lourdes (BA)";"Total";"Total";"28090";"14142";"13948"
"Campo Formoso (BA)";"Total";"Total";"66616";"33464";"33152"
"Canápolis (BA)";"Total";"Total";"9410";"4808";"4602"
"Canarana (BA)";"Total";"Total";"24067";"12126";"11941"
"Canavieiras (BA)";"Total";"Total";"32336";"16089";"16247"
"Candeal (BA)";"Total";"Total";"8895";"4499";"4396"
"Candeias (BA)";"Total";"Total";"83158";"40314";"42844"
"Candiba (BA)";"Total";"Total";"13210";"6815";"6395"
"Cândido Sales (BA)";"Total";"Total";"27918";"14032";"13886"
"Cansanção (BA)";"Total";"Total";"32908";"16560";"16348"
"Canudos (BA)";"Total";"Total";"15732";"7997";"7735"
"Capela do Alto Alegre (BA)";"Total";"Total";"11527";"5808";"5719"
"Capim Grosso (BA)";"Total";"Total";"26577";"12998";"13579"
"Caraíbas (BA)";"Total";"Total";"10222";"5216";"5006"
"Caravelas (BA)";"Total";"Total";"21414";"10873";"10541"
"Cardeal da Silva (BA)";"Total";"Total";"8899";"4502";"4397"
"Carinhanha (BA)";"Total";"Total";"28380";"14523";"13857"
"Casa Nova (BA)";"Total";"Total";"64940";"33091";"31849"
"Castro Alves (BA)";"Total";"Total";"25408";"12268";"13140"
"Catolândia (BA)";"Total";"Total";"2612";"1354";"1258"
"Catu (BA)";"Total";"Total";"51077";"24816";"26261"
"Caturama (BA)";"Total";"Total";"8843";"4543";"4300"
"Central (BA)";"Total";"Total";"17013";"8689";"8324"
"Chorrochó (BA)";"Total";"Total";"10734";"5442";"5292"
"Cícero Dantas (BA)";"Total";"Total";"32300";"15860";"16440"
"Cipó (BA)";"Total";"Total";"15755";"7678";"8077"
"Coaraci (BA)";"Total";"Total";"20964";"10274";"10690"
"Cocos (BA)";"Total";"Total";"18153";"9303";"8850"
"Conceição da Feira (BA)";"Total";"Total";"20391";"9922";"10469"
"Conceição do Almeida (BA)";"Total";"Total";"17889";"8704";"9185"
"Conceição do Coité (BA)";"Total";"Total";"62040";"30707";"31333"
"Conceição do Jacuípe (BA)";"Total";"Total";"30123";"14559";"15564"
"Conde (BA)";"Total";"Total";"23620";"11834";"11786"
"Condeúba (BA)";"Total";"Total";"16898";"8270";"8628"
"Contendas do Sincorá (BA)";"Total";"Total";"4663";"2380";"2283"
"Coração de Maria (BA)";"Total";"Total";"22401";"10841";"11560"
"Cordeiros (BA)";"Total";"Total";"8168";"4048";"4120"
"Coribe (BA)";"Total";"Total";"14307";"7199";"7108"
"Coronel João Sá (BA)";"Total";"Total";"17066";"8796";"8270"
"Correntina (BA)";"Total";"Total";"31249";"15763";"15486"
"Cotegipe (BA)";"Total";"Total";"13636";"7115";"6521"
"Cravolândia (BA)";"Total";"Total";"5041";"2557";"2484"
"Crisópolis (BA)";"Total";"Total";"20046";"10236";"9810"
"Cristópolis (BA)";"Total";"Total";"13280";"6869";"6411"
"Cruz das Almas (BA)";"Total";"Total";"58606";"27682";"30924"
"Curaçá (BA)";"Total";"Total";"32168";"16467";"15701"
"Dário Meira (BA)";"Total";"Total";"12836";"6726";"6110"
"Dias d'Ávila (BA)";"Total";"Total";"66440";"32818";"33622"
"Dom Basílio (BA)";"Total";"Total";"11355";"5870";"5485"
"Dom Macedo Costa (BA)";"Total";"Total";"3874";"1897";"1977"
"Elísio Medrado (BA)";"Total";"Total";"7947";"3957";"3990"
"Encruzilhada (BA)";"Total";"Total";"23766";"12376";"11390"
"Entre Rios (BA)";"Total";"Total";"39872";"19631";"20241"
"Esplanada (BA)";"Total";"Total";"32802";"16334";"16468"
"Euclides da Cunha (BA)";"Total";"Total";"56289";"28319";"27970"
"Eunápolis (BA)";"Total";"Total";"100196";"49396";"50800"
"Fátima (BA)";"Total";"Total";"17652";"8949";"8703"
"Feira da Mata (BA)";"Total";"Total";"6184";"3197";"2987"
"Feira de Santana (BA)";"Total";"Total";"556642";"263999";"292643"
"Filadélfia (BA)";"Total";"Total";"16740";"8437";"8303"
"Firmino Alves (BA)";"Total";"Total";"5384";"2732";"2652"
"Floresta Azul (BA)";"Total";"Total";"10660";"5438";"5222"
"Formosa do Rio Preto (BA)";"Total";"Total";"22528";"11660";"10868"
"Gandu (BA)";"Total";"Total";"30336";"15103";"15233"
"Gavião (BA)";"Total";"Total";"4561";"2356";"2205"
"Gentio do Ouro (BA)";"Total";"Total";"10622";"5448";"5174"
"Glória (BA)";"Total";"Total";"15076";"7539";"7537"
"Gongogi (BA)";"Total";"Total";"8357";"4235";"4122"
"Governador Mangabeira (BA)";"Total";"Total";"19818";"9497";"10321"
"Guajeru (BA)";"Total";"Total";"10412";"5242";"5170"
"Guanambi (BA)";"Total";"Total";"78833";"38481";"40352"
"Guaratinga (BA)";"Total";"Total";"22165";"11618";"10547"
"Heliópolis (BA)";"Total";"Total";"13192";"6666";"6526"
"Iaçu (BA)";"Total";"Total";"25736";"12631";"13105"
"Ibiassucê (BA)";"Total";"Total";"10062";"5097";"4965"
"Ibicaraí (BA)";"Total";"Total";"24272";"11888";"12384"
"Ibicoara (BA)";"Total";"Total";"17282";"8754";"8528"
"Ibicuí (BA)";"Total";"Total";"15785";"8063";"7722"
"Ibipeba (BA)";"Total";"Total";"17008";"8758";"8250"
"Ibipitanga (BA)";"Total";"Total";"14171";"7048";"7123"
"Ibiquera (BA)";"Total";"Total";"4866";"2529";"2337"
"Ibirapitanga (BA)";"Total";"Total";"22598";"11534";"11064"
"Ibirapuã (BA)";"Total";"Total";"7956";"4098";"3858"
"Ibirataia (BA)";"Total";"Total";"18943";"9440";"9503"
"Ibitiara (BA)";"Total";"Total";"15508";"7695";"7813"
"Ibititá (BA)";"Total";"Total";"17840";"9058";"8782"
"Ibotirama (BA)";"Total";"Total";"25424";"12802";"12622"
"Ichu (BA)";"Total";"Total";"5255";"2588";"2667"
"Igaporã (BA)";"Total";"Total";"15205";"7643";"7562"
"Igrapiúna (BA)";"Total";"Total";"13343";"7042";"6301"
"Iguaí (BA)";"Total";"Total";"25705";"13123";"12582"
"Ilhéus (BA)";"Total";"Total";"184236";"89440";"94796"
"Inhambupe (BA)";"Total";"Total";"36306";"18028";"18278"
"Ipecaetá (BA)";"Total";"Total";"15331";"7586";"7745"
"Ipiaú (BA)";"Total";"Total";"44390";"21831";"22559"
"Ipirá (BA)";"Total";"Total";"59343";"29076";"30267"
"Ipupiara (BA)";"Total";"Total";"9285";"4741";"4544"
"Irajuba (BA)";"Total";"Total";"7002";"3506";"3496"
"Iramaia (BA)";"Total";"Total";"11990";"6167";"5823"
"Iraquara (BA)";"Total";"Total";"22601";"11244";"11357"
"Irará (BA)";"Total";"Total";"27466";"13297";"14169"
"Irecê (BA)";"Total";"Total";"66181";"32018";"34163"
"Itabela (BA)";"Total";"Total";"28390";"14481";"13909"
"Itaberaba (BA)";"Total";"Total";"61631";"29935";"31696"
"Itabuna (BA)";"Total";"Total";"204667";"96936";"107731"
"Itacaré (BA)";"Total";"Total";"24318";"12697";"11621"
"Itaeté (BA)";"Total";"Total";"14924";"7513";"7411"
"Itagi (BA)";"Total";"Total";"13051";"6588";"6463"
"Itagibá (BA)";"Total";"Total";"15193";"7804";"7389"
"Itagimirim (BA)";"Total";"Total";"7110";"3556";"3554"
"Itaguaçu da Bahia (BA)";"Total";"Total";"13209";"6959";"6250"
"Itaju do Colônia (BA)";"Total";"Total";"7309";"3699";"3610"
"Itajuípe (BA)";"Total";"Total";"21081";"10452";"10629"
"Itamaraju (BA)";"Total";"Total";"63069";"31460";"31609"
"Itamari (BA)";"Total";"Total";"7903";"4036";"3867"
"Itambé (BA)";"Total";"Total";"23089";"11583";"11506"
"Itanagra (BA)";"Total";"Total";"7598";"3885";"3713"
"Itanhém (BA)";"Total";"Total";"20216";"10295";"9921"
"Itaparica (BA)";"Total";"Total";"20725";"10166";"10559"
"Itapé (BA)";"Total";"Total";"10995";"5608";"5387"
"Itapebi (BA)";"Total";"Total";"10495";"5260";"5235"
"Itapetinga (BA)";"Total";"Total";"68273";"33449";"34824"
"Itapicuru (BA)";"Total";"Total";"32261";"16467";"15794"
"Itapitanga (BA)";"Total";"Total";"10207";"5178";"5029"
"Itaquara (BA)";"Total";"Total";"7678";"3842";"3836"
"Itarantim (BA)";"Total";"Total";"18539";"9523";"9016"
"Itatim (BA)";"Total";"Total";"14522";"7252";"7270"
"Itiruçu (BA)";"Total";"Total";"12693";"6241";"6452"
"Itiúba (BA)";"Total";"Total";"36113";"18317";"17796"
"Itororó (BA)";"Total";"Total";"19914";"9990";"9924"
"Ituaçu (BA)";"Total";"Total";"18127";"9031";"9096"
"Ituberá (BA)";"Total";"Total";"26591";"13388";"13203"
"Iuiu (BA)";"Total";"Total";"10900";"5646";"5254"
"Jaborandi (BA)";"Total";"Total";"8973";"4660";"4313"
"Jacaraci (BA)";"Total";"Total";"13651";"6926";"6725"
"Jacobina (BA)";"Total";"Total";"79247";"38328";"40919"
"Jaguaquara (BA)";"Total";"Total";"51011";"25042";"25969"
"Jaguarari (BA)";"Total";"Total";"30343";"15438";"14905"
"Jaguaripe (BA)";"Total";"Total";"16467";"8449";"8018"
"Jandaíra (BA)";"Total";"Total";"10331";"5309";"5022"
"Jequié (BA)";"Total";"Total";"151895";"73612";"78283"
"Jeremoabo (BA)";"Total";"Total";"37680";"19018";"18662"
"Jiquiriçá (BA)";"Total";"Total";"14118";"7155";"6963"
"Jitaúna (BA)";"Total";"Total";"14115";"7124";"6991"
"João Dourado (BA)";"Total";"Total";"22549";"11383";"11166"
"Juazeiro (BA)";"Total";"Total";"197965";"97085";"100880"
"Jucuruçu (BA)";"Total";"Total";"10290";"5399";"4891"
"Jussara (BA)";"Total";"Total";"15052";"7812";"7240"
"Jussari (BA)";"Total";"Total";"6474";"3280";"3194"
"Jussiape (BA)";"Total";"Total";"8031";"3907";"4124"
"Lafaiete Coutinho (BA)";"Total";"Total";"3901";"2030";"1871"
"Lagoa Real (BA)";"Total";"Total";"13934";"7200";"6734"
"Laje (BA)";"Total";"Total";"22201";"11286";"10915"
"Lajedão (BA)";"Total";"Total";"3733";"1837";"1896"
"Lajedinho (BA)";"Total";"Total";"3936";"2045";"1891"
"Lajedo do Tabocal (BA)";"Total";"Total";"8305";"4187";"4118"
"Lamarão (BA)";"Total";"Total";"9560";"4761";"4799"
"Lapão (BA)";"Total";"Total";"25646";"13083";"12563"
"Lauro de Freitas (BA)";"Total";"Total";"163449";"79276";"84173"
"Lençóis (BA)";"Total";"Total";"10368";"5210";"5158"
"Licínio de Almeida (BA)";"Total";"Total";"12311";"6276";"6035"
"Livramento de Nossa Senhora (BA)";"Total";"Total";"42693";"21492";"21201"
"Luís Eduardo Magalhães (BA)";"Total";"Total";"60105";"31056";"29049"
"Macajuba (BA)";"Total";"Total";"11229";"5520";"5709"
"Macarani (BA)";"Total";"Total";"17093";"8583";"8510"
"Macaúbas (BA)";"Total";"Total";"47051";"23541";"23510"
"Macururé (BA)";"Total";"Total";"8073";"4001";"4072"
"Madre de Deus (BA)";"Total";"Total";"17376";"8377";"8999"
"Maetinga (BA)";"Total";"Total";"7038";"3581";"3457"
"Maiquinique (BA)";"Total";"Total";"8782";"4544";"4238"
"Mairi (BA)";"Total";"Total";"19326";"9555";"9771"
"Malhada (BA)";"Total";"Total";"16014";"8285";"7729"
"Malhada de Pedras (BA)";"Total";"Total";"8468";"4322";"4146"
"Manoel Vitorino (BA)";"Total";"Total";"14387";"7338";"7049"
"Mansidão (BA)";"Total";"Total";"12592";"6585";"6007"
"Maracás (BA)";"Total";"Total";"24613";"12204";"12409"
"Maragogipe (BA)";"Total";"Total";"42815";"21516";"21299"
"Maraú (BA)";"Total";"Total";"19101";"10076";"9025"
"Marcionílio Souza (BA)";"Total";"Total";"10500";"5298";"5202"
"Mascote (BA)";"Total";"Total";"14640";"7551";"7089"
"Mata de São João (BA)";"Total";"Total";"40183";"19879";"20304"
"Matina (BA)";"Total";"Total";"11145";"5674";"5471"
"Medeiros Neto (BA)";"Total";"Total";"21560";"11049";"10511"
"Miguel Calmon (BA)";"Total";"Total";"26475";"13197";"13278"
"Milagres (BA)";"Total";"Total";"10306";"5003";"5303"
"Mirangaba (BA)";"Total";"Total";"16279";"8176";"8103"
"Mirante (BA)";"Total";"Total";"10507";"5393";"5114"
"Monte Santo (BA)";"Total";"Total";"52338";"26586";"25752"
"Morpará (BA)";"Total";"Total";"8280";"4241";"4039"
"Morro do Chapéu (BA)";"Total";"Total";"35164";"17688";"17476"
"Mortugaba (BA)";"Total";"Total";"12477";"6227";"6250"
"Mucugê (BA)";"Total";"Total";"10545";"5228";"5317"
"Mucuri (BA)";"Total";"Total";"36026";"18186";"17840"
"Mulungu do Morro (BA)";"Total";"Total";"12249";"6175";"6074"
"Mundo Novo (BA)";"Total";"Total";"24395";"12365";"12030"
"Muniz Ferreira (BA)";"Total";"Total";"7317";"3681";"3636"
"Muquém do São Francisco (BA)";"Total";"Total";"10272";"5449";"4823"
"Muritiba (BA)";"Total";"Total";"28899";"13726";"15173"
"Mutuípe (BA)";"Total";"Total";"21449";"10597";"10852"
"Nazaré (BA)";"Total";"Total";"27274";"13225";"14049"
"Nilo Peçanha (BA)";"Total";"Total";"12530";"6464";"6066"
"Nordestina (BA)";"Total";"Total";"12371";"6407";"5964"
"Nova Canaã (BA)";"Total";"Total";"16713";"8571";"8142"
"Nova Fátima (BA)";"Total";"Total";"7602";"3793";"3809"
"Nova Ibiá (BA)";"Total";"Total";"6648";"3492";"3156"
"Nova Itarana (BA)";"Total";"Total";"7435";"3771";"3664"
"Nova Redenção (BA)";"Total";"Total";"8034";"4069";"3965"
"Nova Soure (BA)";"Total";"Total";"24136";"12130";"12006"
"Nova Viçosa (BA)";"Total";"Total";"38556";"19418";"19138"
"Novo Horizonte (BA)";"Total";"Total";"10673";"5502";"5171"
"Novo Triunfo (BA)";"Total";"Total";"15051";"7533";"7518"
"Olindina (BA)";"Total";"Total";"24943";"12290";"12653"
"Oliveira dos Brejinhos (BA)";"Total";"Total";"21831";"11131";"10700"
"Ouriçangas (BA)";"Total";"Total";"8298";"4217";"4081"
"Ourolândia (BA)";"Total";"Total";"16425";"8362";"8063"
"Palmas de Monte Alto (BA)";"Total";"Total";"20775";"10599";"10176"
"Palmeiras (BA)";"Total";"Total";"8410";"4174";"4236"
"Paramirim (BA)";"Total";"Total";"21001";"10565";"10436"
"Paratinga (BA)";"Total";"Total";"29504";"14930";"14574"
"Paripiranga (BA)";"Total";"Total";"27778";"13670";"14108"
"Pau Brasil (BA)";"Total";"Total";"10852";"5495";"5357"
"Paulo Afonso (BA)";"Total";"Total";"108396";"51970";"56426"
"Pé de Serra (BA)";"Total";"Total";"13752";"6817";"6935"
"Pedrão (BA)";"Total";"Total";"6876";"3394";"3482"
"Pedro Alexandre (BA)";"Total";"Total";"16995";"8683";"8312"
"Piatã (BA)";"Total";"Total";"17982";"8734";"9248"
"Pilão Arcado (BA)";"Total";"Total";"32860";"16683";"16177"
"Pindaí (BA)";"Total";"Total";"15628";"8017";"7611"
"Pindobaçu (BA)";"Total";"Total";"20121";"10329";"9792"
"Pintadas (BA)";"Total";"Total";"10342";"5198";"5144"
"Piraí do Norte (BA)";"Total";"Total";"9799";"5194";"4605"
"Piripá (BA)";"Total";"Total";"12783";"6440";"6343"
"Piritiba (BA)";"Total";"Total";"22399";"11287";"11112"
"Planaltino (BA)";"Total";"Total";"8822";"4574";"4248"
"Planalto (BA)";"Total";"Total";"24481";"12092";"12389"
"Poções (BA)";"Total";"Total";"44701";"21762";"22939"
"Pojuca (BA)";"Total";"Total";"33066";"16078";"16988"
"Ponto Novo (BA)";"Total";"Total";"15742";"7924";"7818"
"Porto Seguro (BA)";"Total";"Total";"126929";"63489";"63440"
"Potiraguá (BA)";"Total";"Total";"9810";"5066";"4744"
"Prado (BA)";"Total";"Total";"27627";"13990";"13637"
"Presidente Dutra (BA)";"Total";"Total";"13750";"6992";"6758"
"Presidente Jânio Quadros (BA)";"Total";"Total";"13652";"6978";"6674"
"Presidente Tancredo Neves (BA)";"Total";"Total";"23846";"12212";"11634"
"Queimadas (BA)";"Total";"Total";"24602";"12285";"12317"
"Quijingue (BA)";"Total";"Total";"27228";"14011";"13217"
"Quixabeira (BA)";"Total";"Total";"9554";"4879";"4675"
"Rafael Jambeiro (BA)";"Total";"Total";"22874";"11136";"11738"
"Remanso (BA)";"Total";"Total";"38957";"19451";"19506"
"Retirolândia (BA)";"Total";"Total";"12055";"6025";"6030"
"Riachão das Neves (BA)";"Total";"Total";"21937";"11440";"10497"
"Riachão do Jacuípe (BA)";"Total";"Total";"33172";"16169";"17003"
"Riacho de Santana (BA)";"Total";"Total";"30646";"15594";"15052"
"Ribeira do Amparo (BA)";"Total";"Total";"14276";"7234";"7042"
"Ribeira do Pombal (BA)";"Total";"Total";"47518";"23376";"24142"
"Ribeirão do Largo (BA)";"Total";"Total";"8602";"4474";"4128"
"Rio de Contas (BA)";"Total";"Total";"13007";"6233";"6774"
"Rio do Antônio (BA)";"Total";"Total";"14815";"7441";"7374"
"Rio do Pires (BA)";"Total";"Total";"11918";"5928";"5990"
"Rio Real (BA)";"Total";"Total";"37164";"18654";"18510"
"Rodelas (BA)";"Total";"Total";"7775";"3835";"3940"
"Ruy Barbosa (BA)";"Total";"Total";"29887";"14549";"15338"
"Salinas da Margarida (BA)";"Total";"Total";"13456";"6554";"6902"
"Salvador (BA)";"Total";"Total";"2675656";"1248897";"1426759"
"Santa Bárbara (BA)";"Total";"Total";"19064";"9300";"9764"
"Santa Brígida (BA)";"Total";"Total";"15060";"7715";"7345"
"Santa Cruz Cabrália (BA)";"Total";"Total";"26264";"13331";"12933"
"Santa Cruz da Vitória (BA)";"Total";"Total";"6673";"3422";"3251"
"Santa Inês (BA)";"Total";"Total";"10363";"5135";"5228"
"Santaluz (BA)";"Total";"Total";"33838";"16620";"17218"
"Santa Luzia (BA)";"Total";"Total";"13344";"7051";"6293"
"Santa Maria da Vitória (BA)";"Total";"Total";"40309";"20337";"19972"
"Santana (BA)";"Total";"Total";"24750";"12551";"12199"
"Santanópolis (BA)";"Total";"Total";"8776";"4246";"4530"
"Santa Rita de Cássia (BA)";"Total";"Total";"26250";"13572";"12678"
"Santa Terezinha (BA)";"Total";"Total";"9648";"4822";"4826"
"Santo Amaro (BA)";"Total";"Total";"57800";"27755";"30045"
"Santo Antônio de Jesus (BA)";"Total";"Total";"90985";"42965";"48020"
"Santo Estêvão (BA)";"Total";"Total";"47880";"22906";"24974"
"São Desidério (BA)";"Total";"Total";"27659";"14530";"13129"
"São Domingos (BA)";"Total";"Total";"9226";"4591";"4635"
"São Félix (BA)";"Total";"Total";"14098";"6882";"7216"
"São Félix do Coribe (BA)";"Total";"Total";"13048";"6536";"6512"
"São Felipe (BA)";"Total";"Total";"20305";"10083";"10222"
"São Francisco do Conde (BA)";"Total";"Total";"33183";"16203";"16980"
"São Gabriel (BA)";"Total";"Total";"18427";"9449";"8978"
"São Gonçalo dos Campos (BA)";"Total";"Total";"33283";"16019";"17264"
"São José da Vitória (BA)";"Total";"Total";"5715";"2902";"2813"
"São José do Jacuípe (BA)";"Total";"Total";"10180";"5094";"5086"
"São Miguel das Matas (BA)";"Total";"Total";"10414";"5278";"5136"
"São Sebastião do Passé (BA)";"Total";"Total";"42153";"20708";"21445"
"Sapeaçu (BA)";"Total";"Total";"16585";"7978";"8607"
"Sátiro Dias (BA)";"Total";"Total";"18964";"9567";"9397"
"Saubara (BA)";"Total";"Total";"11201";"5482";"5719"
"Saúde (BA)";"Total";"Total";"11845";"5933";"5912"
"Seabra (BA)";"Total";"Total";"41798";"20685";"21113"
"Sebastião Laranjeiras (BA)";"Total";"Total";"10371";"5254";"5117"
"Senhor do Bonfim (BA)";"Total";"Total";"74419";"36020";"38399"
"Serra do Ramalho (BA)";"Total";"Total";"31638";"16377";"15261"
"Sento Sé (BA)";"Total";"Total";"37425";"19277";"18148"
"Serra Dourada (BA)";"Total";"Total";"18112";"9243";"8869"
"Serra Preta (BA)";"Total";"Total";"15401";"7587";"7814"
"Serrinha (BA)";"Total";"Total";"76762";"37680";"39082"
"Serrolândia (BA)";"Total";"Total";"12344";"6040";"6304"
"Simões Filho (BA)";"Total";"Total";"118047";"58013";"60034"
"Sítio do Mato (BA)";"Total";"Total";"12050";"6265";"5785"
"Sítio do Quinto (BA)";"Total";"Total";"12592";"6282";"6310"
"Sobradinho (BA)";"Total";"Total";"22000";"10799";"11201"
"Souto Soares (BA)";"Total";"Total";"15899";"8053";"7846"
"Tabocas do Brejo Velho (BA)";"Total";"Total";"11431";"5939";"5492"
"Tanhaçu (BA)";"Total";"Total";"20013";"10071";"9942"
"Tanque Novo (BA)";"Total";"Total";"16128";"8126";"8002"
"Tanquinho (BA)";"Total";"Total";"8008";"3977";"4031"
"Taperoá (BA)";"Total";"Total";"18748";"9586";"9162"
"Tapiramutá (BA)";"Total";"Total";"16516";"8337";"8179"
"Teixeira de Freitas (BA)";"Total";"Total";"138341";"68077";"70264"
"Teodoro Sampaio (BA)";"Total";"Total";"7895";"3856";"4039"
"Teofilândia (BA)";"Total";"Total";"21482";"10801";"10681"
"Teolândia (BA)";"Total";"Total";"14836";"7725";"7111"
"Terra Nova (BA)";"Total";"Total";"12803";"6221";"6582"
"Tremedal (BA)";"Total";"Total";"17029";"8532";"8497"
"Tucano (BA)";"Total";"Total";"52418";"26254";"26164"
"Uauá (BA)";"Total";"Total";"24294";"12218";"12076"
"Ubaíra (BA)";"Total";"Total";"19750";"10035";"9715"
"Ubaitaba (BA)";"Total";"Total";"20691";"10100";"10591"
"Ubatã (BA)";"Total";"Total";"25004";"12488";"12516"
"Uibaí (BA)";"Total";"Total";"13625";"6968";"6657"
"Umburanas (BA)";"Total";"Total";"17000";"8777";"8223"
"Una (BA)";"Total";"Total";"24110";"12557";"11553"
"Urandi (BA)";"Total";"Total";"16466";"8331";"8135"
"Uruçuca (BA)";"Total";"Total";"19837";"9857";"9980"
"Utinga (BA)";"Total";"Total";"18173";"8936";"9237"
"Valença (BA)";"Total";"Total";"88673";"43531";"45142"
"Valente (BA)";"Total";"Total";"24560";"12152";"12408"
"Várzea da Roça (BA)";"Total";"Total";"13786";"6984";"6802"
"Várzea do Poço (BA)";"Total";"Total";"8661";"4355";"4306"
"Várzea Nova (BA)";"Total";"Total";"13073";"6622";"6451"
"Varzedo (BA)";"Total";"Total";"9109";"4534";"4575"
"Vera Cruz (BA)";"Total";"Total";"37567";"18722";"18845"
"Vereda (BA)";"Total";"Total";"6800";"3564";"3236"
"Vitória da Conquista (BA)";"Total";"Total";"306866";"147879";"158987"
"Wagner (BA)";"Total";"Total";"8983";"4498";"4485"
"Wanderley (BA)";"Total";"Total";"12485";"6496";"5989"
"Wenceslau Guimarães (BA)";"Total";"Total";"22189";"11475";"10714"
"Xique-Xique (BA)";"Total";"Total";"45536";"22509";"23027"
"Abadia dos Dourados (MG)";"Total";"Total";"6704";"3400";"3304"
"Abaeté (MG)";"Total";"Total";"22690";"11230";"11460"
"Abre Campo (MG)";"Total";"Total";"13311";"6669";"6642"
"Acaiaca (MG)";"Total";"Total";"3920";"1894";"2026"
"Açucena (MG)";"Total";"Total";"10276";"5228";"5048"
"Água Boa (MG)";"Total";"Total";"15195";"7742";"7453"
"Água Comprida (MG)";"Total";"Total";"2025";"1073";"952"
"Aguanil (MG)";"Total";"Total";"4054";"2061";"1993"
"Águas Formosas (MG)";"Total";"Total";"18479";"9318";"9161"
"Águas Vermelhas (MG)";"Total";"Total";"12722";"6526";"6196"
"Aimorés (MG)";"Total";"Total";"24959";"12061";"12898"
"Aiuruoca (MG)";"Total";"Total";"6162";"3206";"2956"
"Alagoa (MG)";"Total";"Total";"2709";"1408";"1301"
"Albertina (MG)";"Total";"Total";"2913";"1488";"1425"
"Além Paraíba (MG)";"Total";"Total";"34349";"16538";"17811"
"Alfenas (MG)";"Total";"Total";"73774";"36081";"37693"
"Alfredo Vasconcelos (MG)";"Total";"Total";"6075";"3110";"2965"
"Almenara (MG)";"Total";"Total";"38775";"19534";"19241"
"Alpercata (MG)";"Total";"Total";"7172";"3590";"3582"
"Alpinópolis (MG)";"Total";"Total";"18488";"9493";"8995"
"Alterosa (MG)";"Total";"Total";"13717";"6981";"6736"
"Alto Caparaó (MG)";"Total";"Total";"5297";"2726";"2571"
"Alto Rio Doce (MG)";"Total";"Total";"12159";"6102";"6057"
"Alvarenga (MG)";"Total";"Total";"4444";"2239";"2205"
"Alvinópolis (MG)";"Total";"Total";"15261";"7535";"7726"
"Alvorada de Minas (MG)";"Total";"Total";"3546";"1779";"1767"
"Amparo do Serra (MG)";"Total";"Total";"5053";"2484";"2569"
"Andradas (MG)";"Total";"Total";"37270";"18681";"18589"
"Cachoeira de Pajeú (MG)";"Total";"Total";"8959";"4510";"4449"
"Andrelândia (MG)";"Total";"Total";"12173";"6066";"6107"
"Angelândia (MG)";"Total";"Total";"8003";"3950";"4053"
"Antônio Carlos (MG)";"Total";"Total";"11114";"5530";"5584"
"Antônio Dias (MG)";"Total";"Total";"9565";"4829";"4736"
"Antônio Prado de Minas (MG)";"Total";"Total";"1671";"861";"810"
"Araçaí (MG)";"Total";"Total";"2243";"1083";"1160"
"Aracitaba (MG)";"Total";"Total";"2058";"1053";"1005"
"Araçuaí (MG)";"Total";"Total";"36013";"17848";"18165"
"Araguari (MG)";"Total";"Total";"109801";"54160";"55641"
"Arantina (MG)";"Total";"Total";"2823";"1415";"1408"
"Araponga (MG)";"Total";"Total";"8152";"4191";"3961"
"Araporã (MG)";"Total";"Total";"6144";"3111";"3033"
"Arapuá (MG)";"Total";"Total";"2775";"1406";"1369"
"Araújos (MG)";"Total";"Total";"7883";"4010";"3873"
"Araxá (MG)";"Total";"Total";"93672";"46265";"47407"
"Arceburgo (MG)";"Total";"Total";"9509";"4914";"4595"
"Arcos (MG)";"Total";"Total";"36597";"18209";"18388"
"Areado (MG)";"Total";"Total";"13731";"6925";"6806"
"Argirita (MG)";"Total";"Total";"2901";"1485";"1416"
"Aricanduva (MG)";"Total";"Total";"4770";"2429";"2341"
"Arinos (MG)";"Total";"Total";"17674";"9171";"8503"
"Astolfo Dutra (MG)";"Total";"Total";"13049";"6553";"6496"
"Ataléia (MG)";"Total";"Total";"14455";"7311";"7144"
"Augusto de Lima (MG)";"Total";"Total";"4960";"2525";"2435"
"Baependi (MG)";"Total";"Total";"18307";"9175";"9132"
"Baldim (MG)";"Total";"Total";"7913";"3941";"3972"
"Bambuí (MG)";"Total";"Total";"22734";"11252";"11482"
"Bandeira (MG)";"Total";"Total";"4987";"2537";"2450"
"Bandeira do Sul (MG)";"Total";"Total";"5338";"2742";"2596"
"Barão de Cocais (MG)";"Total";"Total";"28442";"14070";"14372"
"Barão de Monte Alto (MG)";"Total";"Total";"5720";"2847";"2873"
"Barbacena (MG)";"Total";"Total";"126284";"60162";"66122"
"Barra Longa (MG)";"Total";"Total";"6143";"3022";"3121"
"Barroso (MG)";"Total";"Total";"19599";"9550";"10049"
"Bela Vista de Minas (MG)";"Total";"Total";"10004";"4820";"5184"
"Belmiro Braga (MG)";"Total";"Total";"3403";"1722";"1681"
"Belo Horizonte (MG)";"Total";"Total";"2375151";"1113513";"1261638"
"Belo Oriente (MG)";"Total";"Total";"23397";"11621";"11776"
"Belo Vale (MG)";"Total";"Total";"7536";"3776";"3760"
"Berilo (MG)";"Total";"Total";"12300";"6283";"6017"
"Bertópolis (MG)";"Total";"Total";"4498";"2384";"2114"
"Berizal (MG)";"Total";"Total";"4370";"2190";"2180"
"Betim (MG)";"Total";"Total";"378089";"186352";"191737"
"Bias Fortes (MG)";"Total";"Total";"3793";"1970";"1823"
"Bicas (MG)";"Total";"Total";"13653";"6558";"7095"
"Biquinhas (MG)";"Total";"Total";"2630";"1320";"1310"
"Boa Esperança (MG)";"Total";"Total";"38516";"19274";"19242"
"Bocaina de Minas (MG)";"Total";"Total";"5007";"2636";"2371"
"Bocaiúva (MG)";"Total";"Total";"46654";"23366";"23288"
"Bom Despacho (MG)";"Total";"Total";"45624";"22625";"22999"
"Bom Jardim de Minas (MG)";"Total";"Total";"6501";"3249";"3252"
"Bom Jesus da Penha (MG)";"Total";"Total";"3887";"2022";"1865"
"Bom Jesus do Amparo (MG)";"Total";"Total";"5491";"2709";"2782"
"Bom Jesus do Galho (MG)";"Total";"Total";"15364";"7824";"7540"
"Bom Repouso (MG)";"Total";"Total";"10457";"5444";"5013"
"Bom Sucesso (MG)";"Total";"Total";"17243";"8551";"8692"
"Bonfim (MG)";"Total";"Total";"6818";"3423";"3395"
"Bonfinópolis de Minas (MG)";"Total";"Total";"5865";"2977";"2888"
"Bonito de Minas (MG)";"Total";"Total";"9673";"4995";"4678"
"Borda da Mata (MG)";"Total";"Total";"17118";"8671";"8447"
"Botelhos (MG)";"Total";"Total";"14920";"7472";"7448"
"Botumirim (MG)";"Total";"Total";"6497";"3395";"3102"
"Brasilândia de Minas (MG)";"Total";"Total";"14226";"7384";"6842"
"Brasília de Minas (MG)";"Total";"Total";"31213";"15591";"15622"
"Brás Pires (MG)";"Total";"Total";"4637";"2322";"2315"
"Braúnas (MG)";"Total";"Total";"5030";"2463";"2567"
"Brazópolis (MG)";"Total";"Total";"14661";"7433";"7228"
"Brumadinho (MG)";"Total";"Total";"33973";"17023";"16950"
"Bueno Brandão (MG)";"Total";"Total";"10892";"5660";"5232"
"Buenópolis (MG)";"Total";"Total";"10292";"5166";"5126"
"Bugre (MG)";"Total";"Total";"3992";"2030";"1962"
"Buritis (MG)";"Total";"Total";"22737";"11552";"11185"
"Buritizeiro (MG)";"Total";"Total";"26922";"13529";"13393"
"Cabeceira Grande (MG)";"Total";"Total";"6453";"3395";"3058"
"Cabo Verde (MG)";"Total";"Total";"13823";"7452";"6371"
"Cachoeira da Prata (MG)";"Total";"Total";"3654";"1718";"1936"
"Cachoeira de Minas (MG)";"Total";"Total";"11034";"5767";"5267"
"Cachoeira Dourada (MG)";"Total";"Total";"2505";"1254";"1251"
"Caetanópolis (MG)";"Total";"Total";"10218";"5115";"5103"
"Caeté (MG)";"Total";"Total";"40750";"19827";"20923"
"Caiana (MG)";"Total";"Total";"4968";"2587";"2381"
"Cajuri (MG)";"Total";"Total";"4047";"2120";"1927"
"Caldas (MG)";"Total";"Total";"13633";"6953";"6680"
"Camacho (MG)";"Total";"Total";"3154";"1665";"1489"
"Camanducaia (MG)";"Total";"Total";"21080";"10857";"10223"
"Cambuí (MG)";"Total";"Total";"26488";"13233";"13255"
"Cambuquira (MG)";"Total";"Total";"12602";"6222";"6380"
"Campanário (MG)";"Total";"Total";"3564";"1734";"1830"
"Campanha (MG)";"Total";"Total";"15433";"7760";"7673"
"Campestre (MG)";"Total";"Total";"20686";"10764";"9922"
"Campina Verde (MG)";"Total";"Total";"19324";"9804";"9520"
"Campo Azul (MG)";"Total";"Total";"3684";"1946";"1738"
"Campo Belo (MG)";"Total";"Total";"51544";"25144";"26400"
"Campo do Meio (MG)";"Total";"Total";"11476";"5829";"5647"
"Campo Florido (MG)";"Total";"Total";"6870";"3679";"3191"
"Campos Altos (MG)";"Total";"Total";"14206";"7263";"6943"
"Campos Gerais (MG)";"Total";"Total";"27600";"14064";"13536"
"Canaã (MG)";"Total";"Total";"4628";"2374";"2254"
"Canápolis (MG)";"Total";"Total";"11365";"5984";"5381"
"Cana Verde (MG)";"Total";"Total";"5589";"2861";"2728"
"Candeias (MG)";"Total";"Total";"14595";"7457";"7138"
"Cantagalo (MG)";"Total";"Total";"4195";"2045";"2150"
"Caparaó (MG)";"Total";"Total";"5209";"2743";"2466"
"Capela Nova (MG)";"Total";"Total";"4755";"2333";"2422"
"Capelinha (MG)";"Total";"Total";"34803";"17145";"17658"
"Capetinga (MG)";"Total";"Total";"7089";"3741";"3348"
"Capim Branco (MG)";"Total";"Total";"8881";"4414";"4467"
"Capinópolis (MG)";"Total";"Total";"15290";"7824";"7466"
"Capitão Andrade (MG)";"Total";"Total";"4925";"2419";"2506"
"Capitão Enéas (MG)";"Total";"Total";"14206";"7203";"7003"
"Capitólio (MG)";"Total";"Total";"8183";"4168";"4015"
"Caputira (MG)";"Total";"Total";"9030";"4640";"4390"
"Caraí (MG)";"Total";"Total";"22343";"11299";"11044"
"Caranaíba (MG)";"Total";"Total";"3288";"1677";"1611"
"Carandaí (MG)";"Total";"Total";"23346";"11561";"11785"
"Carangola (MG)";"Total";"Total";"32296";"15692";"16604"
"Caratinga (MG)";"Total";"Total";"85239";"41671";"43568"
"Carbonita (MG)";"Total";"Total";"9148";"4682";"4466"
"Careaçu (MG)";"Total";"Total";"6298";"3223";"3075"
"Carlos Chagas (MG)";"Total";"Total";"20069";"10007";"10062"
"Carmésia (MG)";"Total";"Total";"2446";"1219";"1227"
"Carmo da Cachoeira (MG)";"Total";"Total";"11836";"5976";"5860"
"Carmo da Mata (MG)";"Total";"Total";"10927";"5452";"5475"
"Carmo de Minas (MG)";"Total";"Total";"13750";"6895";"6855"
"Carmo do Cajuru (MG)";"Total";"Total";"20012";"10030";"9982"
"Carmo do Paranaíba (MG)";"Total";"Total";"29735";"15052";"14683"
"Carmo do Rio Claro (MG)";"Total";"Total";"20426";"10483";"9943"
"Carmópolis de Minas (MG)";"Total";"Total";"17048";"8761";"8287"
"Carneirinho (MG)";"Total";"Total";"9471";"4867";"4604"
"Carrancas (MG)";"Total";"Total";"3948";"2011";"1937"
"Carvalhópolis (MG)";"Total";"Total";"3341";"1704";"1637"
"Carvalhos (MG)";"Total";"Total";"4556";"2340";"2216"
"Casa Grande (MG)";"Total";"Total";"2244";"1152";"1092"
"Cascalho Rico (MG)";"Total";"Total";"2857";"1527";"1330"
"Cássia (MG)";"Total";"Total";"17412";"8800";"8612"
"Conceição da Barra de Minas (MG)";"Total";"Total";"3954";"2063";"1891"
"Cataguases (MG)";"Total";"Total";"69757";"34216";"35541"
"Catas Altas (MG)";"Total";"Total";"4846";"2389";"2457"
"Catas Altas da Noruega (MG)";"Total";"Total";"3462";"1761";"1701"
"Catuji (MG)";"Total";"Total";"6708";"3363";"3345"
"Catuti (MG)";"Total";"Total";"5102";"2627";"2475"
"Caxambu (MG)";"Total";"Total";"21705";"10526";"11179"
"Cedro do Abaeté (MG)";"Total";"Total";"1210";"628";"582"
"Central de Minas (MG)";"Total";"Total";"6772";"3301";"3471"
"Centralina (MG)";"Total";"Total";"10266";"5251";"5015"
"Chácara (MG)";"Total";"Total";"2792";"1410";"1382"
"Chalé (MG)";"Total";"Total";"5645";"2863";"2782"
"Chapada do Norte (MG)";"Total";"Total";"15189";"7446";"7743"
"Chapada Gaúcha (MG)";"Total";"Total";"10805";"5636";"5169"
"Chiador (MG)";"Total";"Total";"2785";"1355";"1430"
"Cipotânea (MG)";"Total";"Total";"6547";"3347";"3200"
"Claraval (MG)";"Total";"Total";"4542";"2370";"2172"
"Claro dos Poções (MG)";"Total";"Total";"7775";"3963";"3812"
"Cláudio (MG)";"Total";"Total";"25771";"13088";"12683"
"Coimbra (MG)";"Total";"Total";"7054";"3547";"3507"
"Coluna (MG)";"Total";"Total";"9024";"4480";"4544"
"Comendador Gomes (MG)";"Total";"Total";"2972";"1591";"1381"
"Comercinho (MG)";"Total";"Total";"8298";"4224";"4074"
"Conceição da Aparecida (MG)";"Total";"Total";"9820";"5008";"4812"
"Conceição das Pedras (MG)";"Total";"Total";"2749";"1468";"1281"
"Conceição das Alagoas (MG)";"Total";"Total";"23043";"12049";"10994"
"Conceição de Ipanema (MG)";"Total";"Total";"4456";"2242";"2214"
"Conceição do Mato Dentro (MG)";"Total";"Total";"17908";"9003";"8905"
"Conceição do Pará (MG)";"Total";"Total";"5158";"2655";"2503"
"Conceição do Rio Verde (MG)";"Total";"Total";"12949";"6518";"6431"
"Conceição dos Ouros (MG)";"Total";"Total";"10388";"5311";"5077"
"Cônego Marinho (MG)";"Total";"Total";"7101";"3604";"3497"
"Confins (MG)";"Total";"Total";"5936";"2923";"3013"
"Congonhal (MG)";"Total";"Total";"10468";"5405";"5063"
"Congonhas (MG)";"Total";"Total";"48519";"23834";"24685"
"Congonhas do Norte (MG)";"Total";"Total";"4943";"2482";"2461"
"Conquista (MG)";"Total";"Total";"6526";"3316";"3210"
"Conselheiro Lafaiete (MG)";"Total";"Total";"116512";"56383";"60129"
"Conselheiro Pena (MG)";"Total";"Total";"22242";"10754";"11488"
"Consolação (MG)";"Total";"Total";"1727";"888";"839"
"Contagem (MG)";"Total";"Total";"603442";"292798";"310644"
"Coqueiral (MG)";"Total";"Total";"9289";"4632";"4657"
"Coração de Jesus (MG)";"Total";"Total";"26033";"13184";"12849"
"Cordisburgo (MG)";"Total";"Total";"8667";"4435";"4232"
"Cordislândia (MG)";"Total";"Total";"3435";"1767";"1668"
"Corinto (MG)";"Total";"Total";"23914";"11760";"12154"
"Coroaci (MG)";"Total";"Total";"10270";"5225";"5045"
"Coromandel (MG)";"Total";"Total";"27547";"13957";"13590"
"Coronel Fabriciano (MG)";"Total";"Total";"103694";"50035";"53659"
"Coronel Murta (MG)";"Total";"Total";"9117";"4658";"4459"
"Coronel Pacheco (MG)";"Total";"Total";"2983";"1516";"1467"
"Coronel Xavier Chaves (MG)";"Total";"Total";"3301";"1645";"1656"
"Córrego Danta (MG)";"Total";"Total";"3391";"1789";"1602"
"Córrego do Bom Jesus (MG)";"Total";"Total";"3730";"1948";"1782"
"Córrego Fundo (MG)";"Total";"Total";"5790";"2983";"2807"
"Córrego Novo (MG)";"Total";"Total";"3127";"1555";"1572"
"Couto de Magalhães de Minas (MG)";"Total";"Total";"4204";"2103";"2101"
"Crisólita (MG)";"Total";"Total";"6047";"3080";"2967"
"Cristais (MG)";"Total";"Total";"11286";"5765";"5521"
"Cristália (MG)";"Total";"Total";"5760";"2911";"2849"
"Cristiano Otoni (MG)";"Total";"Total";"5007";"2516";"2491"
"Cristina (MG)";"Total";"Total";"10210";"5224";"4986"
"Crucilândia (MG)";"Total";"Total";"4757";"2430";"2327"
"Cruzeiro da Fortaleza (MG)";"Total";"Total";"3934";"2008";"1926"
"Cruzília (MG)";"Total";"Total";"14591";"7245";"7346"
"Cuparaque (MG)";"Total";"Total";"4680";"2355";"2325"
"Curral de Dentro (MG)";"Total";"Total";"6913";"3500";"3413"
"Curvelo (MG)";"Total";"Total";"74219";"36141";"38078"
"Datas (MG)";"Total";"Total";"5211";"2551";"2660"
"Delfim Moreira (MG)";"Total";"Total";"7971";"4188";"3783"
"Delfinópolis (MG)";"Total";"Total";"6830";"3550";"3280"
"Delta (MG)";"Total";"Total";"8089";"4538";"3551"
"Descoberto (MG)";"Total";"Total";"4768";"2408";"2360"
"Desterro de Entre Rios (MG)";"Total";"Total";"7002";"3571";"3431"
"Desterro do Melo (MG)";"Total";"Total";"3015";"1546";"1469"
"Diamantina (MG)";"Total";"Total";"45880";"22239";"23641"
"Diogo de Vasconcelos (MG)";"Total";"Total";"3848";"1930";"1918"
"Dionísio (MG)";"Total";"Total";"8739";"4301";"4438"
"Divinésia (MG)";"Total";"Total";"3293";"1655";"1638"
"Divino (MG)";"Total";"Total";"19133";"9681";"9452"
"Divino das Laranjeiras (MG)";"Total";"Total";"4937";"2460";"2477"
"Divinolândia de Minas (MG)";"Total";"Total";"7024";"3479";"3545"
"Divinópolis (MG)";"Total";"Total";"213016";"103828";"109188"
"Divisa Alegre (MG)";"Total";"Total";"5884";"2905";"2979"
"Divisa Nova (MG)";"Total";"Total";"5763";"2982";"2781"
"Divisópolis (MG)";"Total";"Total";"8974";"4659";"4315"
"Dom Bosco (MG)";"Total";"Total";"3814";"2022";"1792"
"Dom Cavati (MG)";"Total";"Total";"5209";"2536";"2673"
"Dom Joaquim (MG)";"Total";"Total";"4535";"2222";"2313"
"Dom Silvério (MG)";"Total";"Total";"5196";"2493";"2703"
"Dom Viçoso (MG)";"Total";"Total";"2994";"1544";"1450"
"Dona Eusébia (MG)";"Total";"Total";"6001";"3038";"2963"
"Dores de Campos (MG)";"Total";"Total";"9299";"4614";"4685"
"Dores de Guanhães (MG)";"Total";"Total";"5223";"2612";"2611"
"Dores do Indaiá (MG)";"Total";"Total";"13778";"6715";"7063"
"Dores do Turvo (MG)";"Total";"Total";"4462";"2297";"2165"
"Doresópolis (MG)";"Total";"Total";"1440";"747";"693"
"Douradoquara (MG)";"Total";"Total";"1841";"970";"871"
"Durandé (MG)";"Total";"Total";"7423";"3770";"3653"
"Elói Mendes (MG)";"Total";"Total";"25220";"12489";"12731"
"Engenheiro Caldas (MG)";"Total";"Total";"10280";"4960";"5320"
"Engenheiro Navarro (MG)";"Total";"Total";"7122";"3618";"3504"
"Entre Folhas (MG)";"Total";"Total";"5175";"2570";"2605"
"Entre Rios de Minas (MG)";"Total";"Total";"14242";"7069";"7173"
"Ervália (MG)";"Total";"Total";"17946";"8990";"8956"
"Esmeraldas (MG)";"Total";"Total";"60271";"30270";"30001"
"Espera Feliz (MG)";"Total";"Total";"22856";"11504";"11352"
"Espinosa (MG)";"Total";"Total";"31113";"15291";"15822"
"Espírito Santo do Dourado (MG)";"Total";"Total";"4429";"2342";"2087"
"Estiva (MG)";"Total";"Total";"10845";"5609";"5236"
"Estrela Dalva (MG)";"Total";"Total";"2470";"1233";"1237"
"Estrela do Indaiá (MG)";"Total";"Total";"3516";"1769";"1747"
"Estrela do Sul (MG)";"Total";"Total";"7446";"3899";"3547"
"Eugenópolis (MG)";"Total";"Total";"10540";"5318";"5222"
"Ewbank da Câmara (MG)";"Total";"Total";"3753";"1855";"1898"
"Extrema (MG)";"Total";"Total";"28599";"14414";"14185"
"Fama (MG)";"Total";"Total";"2350";"1180";"1170"
"Faria Lemos (MG)";"Total";"Total";"3376";"1714";"1662"
"Felício dos Santos (MG)";"Total";"Total";"5142";"2568";"2574"
"São Gonçalo do Rio Preto (MG)";"Total";"Total";"3056";"1481";"1575"
"Felisburgo (MG)";"Total";"Total";"6877";"3506";"3371"
"Felixlândia (MG)";"Total";"Total";"14121";"7046";"7075"
"Fernandes Tourinho (MG)";"Total";"Total";"3030";"1549";"1481"
"Ferros (MG)";"Total";"Total";"10837";"5395";"5442"
"Fervedouro (MG)";"Total";"Total";"10349";"5329";"5020"
"Florestal (MG)";"Total";"Total";"6600";"3245";"3355"
"Formiga (MG)";"Total";"Total";"65128";"32137";"32991"
"Formoso (MG)";"Total";"Total";"8177";"4283";"3894"
"Fortaleza de Minas (MG)";"Total";"Total";"4098";"2101";"1997"
"Fortuna de Minas (MG)";"Total";"Total";"2705";"1394";"1311"
"Francisco Badaró (MG)";"Total";"Total";"10248";"5279";"4969"
"Francisco Dumont (MG)";"Total";"Total";"4863";"2535";"2328"
"Francisco Sá (MG)";"Total";"Total";"24912";"12942";"11970"
"Franciscópolis (MG)";"Total";"Total";"5800";"2970";"2830"
"Frei Gaspar (MG)";"Total";"Total";"5879";"2968";"2911"
"Frei Inocêncio (MG)";"Total";"Total";"8920";"4355";"4565"
"Frei Lagonegro (MG)";"Total";"Total";"3329";"1688";"1641"
"Fronteira (MG)";"Total";"Total";"14041";"7230";"6811"
"Fronteira dos Vales (MG)";"Total";"Total";"4687";"2389";"2298"
"Fruta de Leite (MG)";"Total";"Total";"5940";"3024";"2916"
"Frutal (MG)";"Total";"Total";"53468";"27073";"26395"
"Funilândia (MG)";"Total";"Total";"3855";"1958";"1897"
"Galiléia (MG)";"Total";"Total";"6951";"3405";"3546"
"Gameleiras (MG)";"Total";"Total";"5139";"2624";"2515"
"Glaucilândia (MG)";"Total";"Total";"2962";"1496";"1466"
"Goiabeira (MG)";"Total";"Total";"3053";"1486";"1567"
"Goianá (MG)";"Total";"Total";"3659";"1845";"1814"
"Gonçalves (MG)";"Total";"Total";"4220";"2192";"2028"
"Gonzaga (MG)";"Total";"Total";"5921";"2927";"2994"
"Gouveia (MG)";"Total";"Total";"11681";"5662";"6019"
"Governador Valadares (MG)";"Total";"Total";"263689";"125237";"138452"
"Grão Mogol (MG)";"Total";"Total";"15024";"7727";"7297"
"Grupiara (MG)";"Total";"Total";"1373";"714";"659"
"Guanhães (MG)";"Total";"Total";"31262";"15201";"16061"
"Guapé (MG)";"Total";"Total";"13872";"7281";"6591"
"Guaraciaba (MG)";"Total";"Total";"10223";"5174";"5049"
"Guaraciama (MG)";"Total";"Total";"4718";"2378";"2340"
"Guaranésia (MG)";"Total";"Total";"18714";"9498";"9216"
"Guarani (MG)";"Total";"Total";"8678";"4423";"4255"
"Guarará (MG)";"Total";"Total";"3929";"1950";"1979"
"Guarda-Mor (MG)";"Total";"Total";"6565";"3427";"3138"
"Guaxupé (MG)";"Total";"Total";"49430";"24619";"24811"
"Guidoval (MG)";"Total";"Total";"7206";"3638";"3568"
"Guimarânia (MG)";"Total";"Total";"7265";"3713";"3552"
"Guiricema (MG)";"Total";"Total";"8707";"4427";"4280"
"Gurinhatã (MG)";"Total";"Total";"6137";"3237";"2900"
"Heliodora (MG)";"Total";"Total";"6121";"3117";"3004"
"Iapu (MG)";"Total";"Total";"10315";"5132";"5183"
"Ibertioga (MG)";"Total";"Total";"5036";"2543";"2493"
"Ibiá (MG)";"Total";"Total";"23218";"11858";"11360"
"Ibiaí (MG)";"Total";"Total";"7839";"4034";"3805"
"Ibiracatu (MG)";"Total";"Total";"6155";"3218";"2937"
"Ibiraci (MG)";"Total";"Total";"12176";"6364";"5812"
"Ibirité (MG)";"Total";"Total";"158954";"77839";"81115"
"Ibitiúra de Minas (MG)";"Total";"Total";"3382";"1760";"1622"
"Ibituruna (MG)";"Total";"Total";"2866";"1448";"1418"
"Icaraí de Minas (MG)";"Total";"Total";"10746";"5567";"5179"
"Igarapé (MG)";"Total";"Total";"34851";"17520";"17331"
"Igaratinga (MG)";"Total";"Total";"9264";"4773";"4491"
"Iguatama (MG)";"Total";"Total";"8029";"4034";"3995"
"Ijaci (MG)";"Total";"Total";"5859";"2964";"2895"
"Ilicínea (MG)";"Total";"Total";"11488";"5860";"5628"
"Imbé de Minas (MG)";"Total";"Total";"6424";"3293";"3131"
"Inconfidentes (MG)";"Total";"Total";"6908";"3521";"3387"
"Indaiabira (MG)";"Total";"Total";"7330";"3735";"3595"
"Indianópolis (MG)";"Total";"Total";"6190";"3231";"2959"
"Ingaí (MG)";"Total";"Total";"2629";"1391";"1238"
"Inhapim (MG)";"Total";"Total";"24294";"12129";"12165"
"Inhaúma (MG)";"Total";"Total";"5760";"2909";"2851"
"Inimutaba (MG)";"Total";"Total";"6724";"3329";"3395"
"Ipaba (MG)";"Total";"Total";"16708";"8411";"8297"
"Ipanema (MG)";"Total";"Total";"18170";"8806";"9364"
"Ipatinga (MG)";"Total";"Total";"239468";"116209";"123259"
"Ipiaçu (MG)";"Total";"Total";"4107";"2096";"2011"
"Ipuiúna (MG)";"Total";"Total";"9521";"4937";"4584"
"Iraí de Minas (MG)";"Total";"Total";"6467";"3381";"3086"
"Itabira (MG)";"Total";"Total";"109783";"52733";"57050"
"Itabirinha (MG)";"Total";"Total";"10692";"5322";"5370"
"Itabirito (MG)";"Total";"Total";"45449";"22337";"23112"
"Itacambira (MG)";"Total";"Total";"4988";"2678";"2310"
"Itacarambi (MG)";"Total";"Total";"17720";"8842";"8878"
"Itaguara (MG)";"Total";"Total";"12372";"6267";"6105"
"Itaipé (MG)";"Total";"Total";"11798";"6015";"5783"
"Itajubá (MG)";"Total";"Total";"90658";"44489";"46169"
"Itamarandiba (MG)";"Total";"Total";"32175";"16144";"16031"
"Itamarati de Minas (MG)";"Total";"Total";"4079";"2104";"1975"
"Itambacuri (MG)";"Total";"Total";"22809";"11032";"11777"
"Itambé do Mato Dentro (MG)";"Total";"Total";"2283";"1179";"1104"
"Itamogi (MG)";"Total";"Total";"10349";"5306";"5043"
"Itamonte (MG)";"Total";"Total";"14003";"7086";"6917"
"Itanhandu (MG)";"Total";"Total";"14175";"6947";"7228"
"Itanhomi (MG)";"Total";"Total";"11856";"5799";"6057"
"Itaobim (MG)";"Total";"Total";"21001";"10493";"10508"
"Itapagipe (MG)";"Total";"Total";"13656";"7124";"6532"
"Itapecerica (MG)";"Total";"Total";"21377";"10603";"10774"
"Itapeva (MG)";"Total";"Total";"8664";"4498";"4166"
"Itatiaiuçu (MG)";"Total";"Total";"9928";"5043";"4885"
"Itaú de Minas (MG)";"Total";"Total";"14945";"7403";"7542"
"Itaúna (MG)";"Total";"Total";"85463";"42099";"43364"
"Itaverava (MG)";"Total";"Total";"5799";"2977";"2822"
"Itinga (MG)";"Total";"Total";"14407";"7352";"7055"
"Itueta (MG)";"Total";"Total";"5830";"2962";"2868"
"Ituiutaba (MG)";"Total";"Total";"97171";"47862";"49309"
"Itumirim (MG)";"Total";"Total";"6139";"3059";"3080"
"Iturama (MG)";"Total";"Total";"34456";"17297";"17159"
"Itutinga (MG)";"Total";"Total";"3913";"1995";"1918"
"Jaboticatubas (MG)";"Total";"Total";"17134";"8705";"8429"
"Jacinto (MG)";"Total";"Total";"12134";"6285";"5849"
"Jacuí (MG)";"Total";"Total";"7502";"3873";"3629"
"Jacutinga (MG)";"Total";"Total";"22772";"11334";"11438"
"Jaguaraçu (MG)";"Total";"Total";"2990";"1508";"1482"
"Jaíba (MG)";"Total";"Total";"33587";"17344";"16243"
"Jampruca (MG)";"Total";"Total";"5067";"2594";"2473"
"Janaúba (MG)";"Total";"Total";"66803";"32795";"34008"
"Januária (MG)";"Total";"Total";"65463";"32344";"33119"
"Japaraíba (MG)";"Total";"Total";"3939";"2012";"1927"
"Japonvar (MG)";"Total";"Total";"8298";"4211";"4087"
"Jeceaba (MG)";"Total";"Total";"5395";"2723";"2672"
"Jenipapo de Minas (MG)";"Total";"Total";"7116";"3662";"3454"
"Jequeri (MG)";"Total";"Total";"12848";"6477";"6371"
"Jequitaí (MG)";"Total";"Total";"8005";"4031";"3974"
"Jequitibá (MG)";"Total";"Total";"5156";"2665";"2491"
"Jequitinhonha (MG)";"Total";"Total";"24131";"12276";"11855"
"Jesuânia (MG)";"Total";"Total";"4768";"2469";"2299"
"Joaíma (MG)";"Total";"Total";"14941";"7503";"7438"
"Joanésia (MG)";"Total";"Total";"5425";"2699";"2726"
"João Monlevade (MG)";"Total";"Total";"73610";"35049";"38561"
"João Pinheiro (MG)";"Total";"Total";"45260";"23048";"22212"
"Joaquim Felício (MG)";"Total";"Total";"4305";"2216";"2089"
"Jordânia (MG)";"Total";"Total";"10324";"5334";"4990"
"José Gonçalves de Minas (MG)";"Total";"Total";"4553";"2358";"2195"
"José Raydan (MG)";"Total";"Total";"4376";"2220";"2156"
"Josenópolis (MG)";"Total";"Total";"4566";"2346";"2220"
"Nova União (MG)";"Total";"Total";"5555";"2796";"2759"
"Juatuba (MG)";"Total";"Total";"22202";"11217";"10985"
"Juiz de Fora (MG)";"Total";"Total";"516247";"244024";"272223"
"Juramento (MG)";"Total";"Total";"4113";"2053";"2060"
"Juruaia (MG)";"Total";"Total";"9238";"4703";"4535"
"Juvenília (MG)";"Total";"Total";"5708";"2923";"2785"
"Ladainha (MG)";"Total";"Total";"16994";"8392";"8602"
"Lagamar (MG)";"Total";"Total";"7600";"3917";"3683"
"Lagoa da Prata (MG)";"Total";"Total";"45984";"22852";"23132"
"Lagoa dos Patos (MG)";"Total";"Total";"4225";"2201";"2024"
"Lagoa Dourada (MG)";"Total";"Total";"12256";"6347";"5909"
"Lagoa Formosa (MG)";"Total";"Total";"17161";"8652";"8509"
"Lagoa Grande (MG)";"Total";"Total";"8631";"4549";"4082"
"Lagoa Santa (MG)";"Total";"Total";"52520";"25735";"26785"
"Lajinha (MG)";"Total";"Total";"19609";"9828";"9781"
"Lambari (MG)";"Total";"Total";"19554";"9640";"9914"
"Lamim (MG)";"Total";"Total";"3452";"1745";"1707"
"Laranjal (MG)";"Total";"Total";"6465";"3254";"3211"
"Lassance (MG)";"Total";"Total";"6484";"3327";"3157"
"Lavras (MG)";"Total";"Total";"92200";"44721";"47479"
"Leandro Ferreira (MG)";"Total";"Total";"3205";"1640";"1565"
"Leme do Prado (MG)";"Total";"Total";"4804";"2395";"2409"
"Leopoldina (MG)";"Total";"Total";"51130";"24546";"26584"
"Liberdade (MG)";"Total";"Total";"5346";"2701";"2645"
"Lima Duarte (MG)";"Total";"Total";"16149";"8141";"8008"
"Limeira do Oeste (MG)";"Total";"Total";"6890";"3532";"3358"
"Lontra (MG)";"Total";"Total";"8397";"4370";"4027"
"Luisburgo (MG)";"Total";"Total";"6234";"3224";"3010"
"Luislândia (MG)";"Total";"Total";"6400";"3293";"3107"
"Luminárias (MG)";"Total";"Total";"5422";"2811";"2611"
"Luz (MG)";"Total";"Total";"17486";"8716";"8770"
"Machacalis (MG)";"Total";"Total";"6976";"3609";"3367"
"Machado (MG)";"Total";"Total";"38688";"19342";"19346"
"Madre de Deus de Minas (MG)";"Total";"Total";"4904";"2463";"2441"
"Malacacheta (MG)";"Total";"Total";"18776";"9159";"9617"
"Mamonas (MG)";"Total";"Total";"6321";"3183";"3138"
"Manga (MG)";"Total";"Total";"19813";"9794";"10019"
"Manhuaçu (MG)";"Total";"Total";"79574";"39190";"40384"
"Manhumirim (MG)";"Total";"Total";"21382";"10518";"10864"
"Mantena (MG)";"Total";"Total";"27111";"13087";"14024"
"Maravilhas (MG)";"Total";"Total";"7163";"3631";"3532"
"Mar de Espanha (MG)";"Total";"Total";"11749";"5712";"6037"
"Maria da Fé (MG)";"Total";"Total";"14216";"7202";"7014"
"Mariana (MG)";"Total";"Total";"54219";"26583";"27636"
"Marilac (MG)";"Total";"Total";"4219";"2059";"2160"
"Mário Campos (MG)";"Total";"Total";"13192";"6641";"6551"
"Maripá de Minas (MG)";"Total";"Total";"2788";"1389";"1399"
"Marliéria (MG)";"Total";"Total";"4012";"1997";"2015"
"Marmelópolis (MG)";"Total";"Total";"2968";"1491";"1477"
"Martinho Campos (MG)";"Total";"Total";"12611";"6373";"6238"
"Martins Soares (MG)";"Total";"Total";"7173";"3656";"3517"
"Mata Verde (MG)";"Total";"Total";"7874";"4141";"3733"
"Materlândia (MG)";"Total";"Total";"4595";"2285";"2310"
"Mateus Leme (MG)";"Total";"Total";"27856";"13813";"14043"
"Matias Barbosa (MG)";"Total";"Total";"13435";"6692";"6743"
"Matias Cardoso (MG)";"Total";"Total";"9979";"5096";"4883"
"Matipó (MG)";"Total";"Total";"17639";"8727";"8912"
"Mato Verde (MG)";"Total";"Total";"12684";"6260";"6424"
"Matozinhos (MG)";"Total";"Total";"33955";"16758";"17197"
"Matutina (MG)";"Total";"Total";"3761";"1852";"1909"
"Medeiros (MG)";"Total";"Total";"3444";"1811";"1633"
"Medina (MG)";"Total";"Total";"21026";"10476";"10550"
"Mendes Pimentel (MG)";"Total";"Total";"6331";"3153";"3178"
"Mercês (MG)";"Total";"Total";"10368";"5156";"5212"
"Mesquita (MG)";"Total";"Total";"6069";"3029";"3040"
"Minas Novas (MG)";"Total";"Total";"30794";"15350";"15444"
"Minduri (MG)";"Total";"Total";"3840";"1889";"1951"
"Mirabela (MG)";"Total";"Total";"13042";"6629";"6413"
"Miradouro (MG)";"Total";"Total";"10251";"5234";"5017"
"Miraí (MG)";"Total";"Total";"13808";"6944";"6864"
"Miravânia (MG)";"Total";"Total";"4549";"2283";"2266"
"Moeda (MG)";"Total";"Total";"4689";"2343";"2346"
"Moema (MG)";"Total";"Total";"7028";"3553";"3475"
"Monjolos (MG)";"Total";"Total";"2360";"1207";"1153"
"Monsenhor Paulo (MG)";"Total";"Total";"8161";"4180";"3981"
"Montalvânia (MG)";"Total";"Total";"15862";"7996";"7866"
"Monte Alegre de Minas (MG)";"Total";"Total";"19619";"10052";"9567"
"Monte Azul (MG)";"Total";"Total";"21994";"10839";"11155"
"Monte Belo (MG)";"Total";"Total";"13061";"6810";"6251"
"Monte Carmelo (MG)";"Total";"Total";"45772";"23066";"22706"
"Monte Formoso (MG)";"Total";"Total";"4656";"2431";"2225"
"Monte Santo de Minas (MG)";"Total";"Total";"21234";"10686";"10548"
"Montes Claros (MG)";"Total";"Total";"361915";"174249";"187666"
"Monte Sião (MG)";"Total";"Total";"21203";"10654";"10549"
"Montezuma (MG)";"Total";"Total";"7464";"3775";"3689"
"Morada Nova de Minas (MG)";"Total";"Total";"8255";"4205";"4050"
"Morro da Garça (MG)";"Total";"Total";"2660";"1376";"1284"
"Morro do Pilar (MG)";"Total";"Total";"3399";"1709";"1690"
"Munhoz (MG)";"Total";"Total";"6257";"3247";"3010"
"Muriaé (MG)";"Total";"Total";"100765";"48757";"52008"
"Mutum (MG)";"Total";"Total";"26661";"13475";"13186"
"Muzambinho (MG)";"Total";"Total";"20430";"10266";"10164"
"Nacip Raydan (MG)";"Total";"Total";"3154";"1586";"1568"
"Nanuque (MG)";"Total";"Total";"40834";"19994";"20840"
"Naque (MG)";"Total";"Total";"6341";"3194";"3147"
"Natalândia (MG)";"Total";"Total";"3280";"1736";"1544"
"Natércia (MG)";"Total";"Total";"4658";"2409";"2249"
"Nazareno (MG)";"Total";"Total";"7954";"4118";"3836"
"Nepomuceno (MG)";"Total";"Total";"25733";"12832";"12901"
"Ninheira (MG)";"Total";"Total";"9815";"5053";"4762"
"Nova Belém (MG)";"Total";"Total";"3732";"1897";"1835"
"Nova Era (MG)";"Total";"Total";"17528";"8349";"9179"
"Nova Lima (MG)";"Total";"Total";"80998";"39151";"41847"
"Nova Módica (MG)";"Total";"Total";"3790";"1903";"1887"
"Nova Ponte (MG)";"Total";"Total";"12812";"6725";"6087"
"Nova Porteirinha (MG)";"Total";"Total";"7398";"3788";"3610"
"Nova Resende (MG)";"Total";"Total";"15374";"8106";"7268"
"Nova Serrana (MG)";"Total";"Total";"73699";"38067";"35632"
"Novo Cruzeiro (MG)";"Total";"Total";"30725";"15256";"15469"
"Novo Oriente de Minas (MG)";"Total";"Total";"10339";"5296";"5043"
"Novorizonte (MG)";"Total";"Total";"4963";"2489";"2474"
"Olaria (MG)";"Total";"Total";"1976";"1060";"916"
"Olhos-d'Água (MG)";"Total";"Total";"5267";"2778";"2489"
"Olímpio Noronha (MG)";"Total";"Total";"2533";"1304";"1229"
"Oliveira (MG)";"Total";"Total";"39466";"19305";"20161"
"Oliveira Fortes (MG)";"Total";"Total";"2123";"1080";"1043"
"Onça de Pitangui (MG)";"Total";"Total";"3055";"1558";"1497"
"Oratórios (MG)";"Total";"Total";"4493";"2234";"2259"
"Orizânia (MG)";"Total";"Total";"7284";"3697";"3587"
"Ouro Branco (MG)";"Total";"Total";"35268";"17577";"17691"
"Ouro Fino (MG)";"Total";"Total";"31568";"15818";"15750"
"Ouro Preto (MG)";"Total";"Total";"70281";"34277";"36004"
"Ouro Verde de Minas (MG)";"Total";"Total";"6016";"3018";"2998"
"Padre Carvalho (MG)";"Total";"Total";"5834";"2973";"2861"
"Padre Paraíso (MG)";"Total";"Total";"18849";"9334";"9515"
"Paineiras (MG)";"Total";"Total";"4631";"2332";"2299"
"Pains (MG)";"Total";"Total";"8014";"4026";"3988"
"Pai Pedro (MG)";"Total";"Total";"5934";"3024";"2910"
"Paiva (MG)";"Total";"Total";"1558";"782";"776"
"Palma (MG)";"Total";"Total";"6545";"3313";"3232"
"Palmópolis (MG)";"Total";"Total";"6931";"3570";"3361"
"Papagaios (MG)";"Total";"Total";"14175";"7237";"6938"
"Paracatu (MG)";"Total";"Total";"84718";"42470";"42248"
"Pará de Minas (MG)";"Total";"Total";"84215";"41639";"42576"
"Paraguaçu (MG)";"Total";"Total";"20245";"10178";"10067"
"Paraisópolis (MG)";"Total";"Total";"19379";"9785";"9594"
"Paraopeba (MG)";"Total";"Total";"22563";"11132";"11431"
"Passabém (MG)";"Total";"Total";"1766";"865";"901"
"Passa Quatro (MG)";"Total";"Total";"15582";"7727";"7855"
"Passa Tempo (MG)";"Total";"Total";"8197";"4133";"4064"
"Passa Vinte (MG)";"Total";"Total";"2079";"1089";"990"
"Passos (MG)";"Total";"Total";"106290";"52568";"53722"
"Patis (MG)";"Total";"Total";"5579";"2918";"2661"
"Patos de Minas (MG)";"Total";"Total";"138710";"67924";"70786"
"Patrocínio (MG)";"Total";"Total";"82471";"41939";"40532"
"Patrocínio do Muriaé (MG)";"Total";"Total";"5287";"2650";"2637"
"Paula Cândido (MG)";"Total";"Total";"9271";"4693";"4578"
"Paulistas (MG)";"Total";"Total";"4918";"2385";"2533"
"Pavão (MG)";"Total";"Total";"8589";"4346";"4243"
"Peçanha (MG)";"Total";"Total";"17260";"8525";"8735"
"Pedra Azul (MG)";"Total";"Total";"23839";"11744";"12095"
"Pedra Bonita (MG)";"Total";"Total";"6673";"3455";"3218"
"Pedra do Anta (MG)";"Total";"Total";"3365";"1681";"1684"
"Pedra do Indaiá (MG)";"Total";"Total";"3875";"1986";"1889"
"Pedra Dourada (MG)";"Total";"Total";"2191";"1136";"1055"
"Pedralva (MG)";"Total";"Total";"11467";"5858";"5609"
"Pedras de Maria da Cruz (MG)";"Total";"Total";"10315";"5293";"5022"
"Pedrinópolis (MG)";"Total";"Total";"3490";"1798";"1692"
"Pedro Leopoldo (MG)";"Total";"Total";"58740";"28746";"29994"
"Pedro Teixeira (MG)";"Total";"Total";"1785";"948";"837"
"Pequeri (MG)";"Total";"Total";"3165";"1563";"1602"
"Pequi (MG)";"Total";"Total";"4076";"2042";"2034"
"Perdigão (MG)";"Total";"Total";"8912";"4555";"4357"
"Perdizes (MG)";"Total";"Total";"14404";"7533";"6871"
"Perdões (MG)";"Total";"Total";"20087";"9875";"10212"
"Periquito (MG)";"Total";"Total";"7036";"3452";"3584"
"Pescador (MG)";"Total";"Total";"4128";"2045";"2083"
"Piau (MG)";"Total";"Total";"2841";"1490";"1351"
"Piedade de Caratinga (MG)";"Total";"Total";"7110";"3649";"3461"
"Piedade de Ponte Nova (MG)";"Total";"Total";"4062";"1992";"2070"
"Piedade do Rio Grande (MG)";"Total";"Total";"4709";"2390";"2319"
"Piedade dos Gerais (MG)";"Total";"Total";"4640";"2417";"2223"
"Pimenta (MG)";"Total";"Total";"8236";"4243";"3993"
"Pingo d'Água (MG)";"Total";"Total";"4420";"2199";"2221"
"Pintópolis (MG)";"Total";"Total";"7211";"3778";"3433"
"Piracema (MG)";"Total";"Total";"6406";"3233";"3173"
"Pirajuba (MG)";"Total";"Total";"4656";"2545";"2111"
"Piranga (MG)";"Total";"Total";"17232";"8648";"8584"
"Piranguçu (MG)";"Total";"Total";"5217";"2702";"2515"
"Piranguinho (MG)";"Total";"Total";"8016";"4066";"3950"
"Pirapetinga (MG)";"Total";"Total";"10364";"5105";"5259"
"Pirapora (MG)";"Total";"Total";"53368";"26146";"27222"
"Piraúba (MG)";"Total";"Total";"10862";"5439";"5423"
"Pitangui (MG)";"Total";"Total";"25311";"12546";"12765"
"Piumhi (MG)";"Total";"Total";"31883";"15850";"16033"
"Planura (MG)";"Total";"Total";"10384";"5451";"4933"
"Poço Fundo (MG)";"Total";"Total";"15959";"8213";"7746"
"Poços de Caldas (MG)";"Total";"Total";"152435";"73680";"78755"
"Pocrane (MG)";"Total";"Total";"8986";"4515";"4471"
"Pompéu (MG)";"Total";"Total";"29105";"14638";"14467"
"Ponte Nova (MG)";"Total";"Total";"57390";"27495";"29895"
"Ponto Chique (MG)";"Total";"Total";"3966";"2019";"1947"
"Ponto dos Volantes (MG)";"Total";"Total";"11345";"5797";"5548"
"Porteirinha (MG)";"Total";"Total";"37627";"18828";"18799"
"Porto Firme (MG)";"Total";"Total";"10417";"5303";"5114"
"Poté (MG)";"Total";"Total";"15667";"7719";"7948"
"Pouso Alegre (MG)";"Total";"Total";"130615";"64519";"66096"
"Pouso Alto (MG)";"Total";"Total";"6213";"3135";"3078"
"Prados (MG)";"Total";"Total";"8391";"4212";"4179"
"Prata (MG)";"Total";"Total";"25802";"13273";"12529"
"Pratápolis (MG)";"Total";"Total";"8807";"4456";"4351"
"Pratinha (MG)";"Total";"Total";"3265";"1699";"1566"
"Presidente Bernardes (MG)";"Total";"Total";"5537";"2780";"2757"
"Presidente Juscelino (MG)";"Total";"Total";"3908";"1996";"1912"
"Presidente Kubitschek (MG)";"Total";"Total";"2959";"1493";"1466"
"Presidente Olegário (MG)";"Total";"Total";"18577";"9533";"9044"
"Alto Jequitibá (MG)";"Total";"Total";"8318";"4249";"4069"
"Prudente de Morais (MG)";"Total";"Total";"9573";"4736";"4837"
"Quartel Geral (MG)";"Total";"Total";"3303";"1683";"1620"
"Queluzito (MG)";"Total";"Total";"1861";"957";"904"
"Raposos (MG)";"Total";"Total";"15342";"7386";"7956"
"Raul Soares (MG)";"Total";"Total";"23818";"11729";"12089"
"Recreio (MG)";"Total";"Total";"10299";"5000";"5299"
"Reduto (MG)";"Total";"Total";"6569";"3380";"3189"
"Resende Costa (MG)";"Total";"Total";"10913";"5373";"5540"
"Resplendor (MG)";"Total";"Total";"17089";"8369";"8720"
"Ressaquinha (MG)";"Total";"Total";"4711";"2349";"2362"
"Riachinho (MG)";"Total";"Total";"8007";"4182";"3825"
"Riacho dos Machados (MG)";"Total";"Total";"9360";"4755";"4605"
"Ribeirão das Neves (MG)";"Total";"Total";"296317";"146982";"149335"
"Ribeirão Vermelho (MG)";"Total";"Total";"3826";"1842";"1984"
"Rio Acima (MG)";"Total";"Total";"9090";"4469";"4621"
"Rio Casca (MG)";"Total";"Total";"14201";"6848";"7353"
"Rio Doce (MG)";"Total";"Total";"2465";"1229";"1236"
"Rio do Prado (MG)";"Total";"Total";"5217";"2677";"2540"
"Rio Espera (MG)";"Total";"Total";"6070";"3069";"3001"
"Rio Manso (MG)";"Total";"Total";"5276";"2773";"2503"
"Rio Novo (MG)";"Total";"Total";"8712";"4373";"4339"
"Rio Paranaíba (MG)";"Total";"Total";"11885";"6091";"5794"
"Rio Pardo de Minas (MG)";"Total";"Total";"29099";"14832";"14267"
"Rio Piracicaba (MG)";"Total";"Total";"14149";"6915";"7234"
"Rio Pomba (MG)";"Total";"Total";"17110";"8509";"8601"
"Rio Preto (MG)";"Total";"Total";"5292";"2671";"2621"
"Rio Vermelho (MG)";"Total";"Total";"13645";"6722";"6923"
"Ritápolis (MG)";"Total";"Total";"4925";"2434";"2491"
"Rochedo de Minas (MG)";"Total";"Total";"2116";"1086";"1030"
"Rodeiro (MG)";"Total";"Total";"6867";"3458";"3409"
"Romaria (MG)";"Total";"Total";"3596";"1867";"1729"
"Rosário da Limeira (MG)";"Total";"Total";"4247";"2183";"2064"
"Rubelita (MG)";"Total";"Total";"7772";"3999";"3773"
"Rubim (MG)";"Total";"Total";"9919";"5062";"4857"
"Sabará (MG)";"Total";"Total";"126269";"60828";"65441"
"Sabinópolis (MG)";"Total";"Total";"15704";"7775";"7929"
"Sacramento (MG)";"Total";"Total";"23896";"12129";"11767"
"Salinas (MG)";"Total";"Total";"39178";"19274";"19904"
"Salto da Divisa (MG)";"Total";"Total";"6859";"3506";"3353"
"Santa Bárbara (MG)";"Total";"Total";"27876";"13670";"14206"
"Santa Bárbara do Leste (MG)";"Total";"Total";"7682";"3922";"3760"
"Santa Bárbara do Monte Verde (MG)";"Total";"Total";"2788";"1455";"1333"
"Santa Bárbara do Tugúrio (MG)";"Total";"Total";"4570";"2323";"2247"
"Santa Cruz de Minas (MG)";"Total";"Total";"7865";"3854";"4011"
"Santa Cruz de Salinas (MG)";"Total";"Total";"4397";"2274";"2123"
"Santa Cruz do Escalvado (MG)";"Total";"Total";"4992";"2508";"2484"
"Santa Efigênia de Minas (MG)";"Total";"Total";"4600";"2265";"2335"
"Santa Fé de Minas (MG)";"Total";"Total";"3968";"2088";"1880"
"Santa Helena de Minas (MG)";"Total";"Total";"6055";"3056";"2999"
"Santa Juliana (MG)";"Total";"Total";"11337";"5831";"5506"
"Santa Luzia (MG)";"Total";"Total";"202942";"98485";"104457"
"Santa Margarida (MG)";"Total";"Total";"15011";"7583";"7428"
"Santa Maria de Itabira (MG)";"Total";"Total";"10552";"5236";"5316"
"Santa Maria do Salto (MG)";"Total";"Total";"5284";"2719";"2565"
"Santa Maria do Suaçuí (MG)";"Total";"Total";"14395";"7154";"7241"
"Santana da Vargem (MG)";"Total";"Total";"7231";"3625";"3606"
"Santana de Cataguases (MG)";"Total";"Total";"3622";"1818";"1804"
"Santana de Pirapama (MG)";"Total";"Total";"8009";"4129";"3880"
"Santana do Deserto (MG)";"Total";"Total";"3860";"1947";"1913"
"Santana do Garambéu (MG)";"Total";"Total";"2234";"1171";"1063"
"Santana do Jacaré (MG)";"Total";"Total";"4607";"2319";"2288"
"Santana do Manhuaçu (MG)";"Total";"Total";"8582";"4393";"4189"
"Santana do Paraíso (MG)";"Total";"Total";"27265";"13663";"13602"
"Santana do Riacho (MG)";"Total";"Total";"4023";"2018";"2005"
"Santana dos Montes (MG)";"Total";"Total";"3822";"1961";"1861"
"Santa Rita de Caldas (MG)";"Total";"Total";"9027";"4603";"4424"
"Santa Rita de Jacutinga (MG)";"Total";"Total";"4993";"2536";"2457"
"Santa Rita de Minas (MG)";"Total";"Total";"6547";"3297";"3250"
"Santa Rita de Ibitipoca (MG)";"Total";"Total";"3583";"1846";"1737"
"Santa Rita do Itueto (MG)";"Total";"Total";"5697";"2929";"2768"
"Santa Rita do Sapucaí (MG)";"Total";"Total";"37754";"18863";"18891"
"Santa Rosa da Serra (MG)";"Total";"Total";"3224";"1691";"1533"
"Santa Vitória (MG)";"Total";"Total";"18138";"9408";"8730"
"Santo Antônio do Amparo (MG)";"Total";"Total";"17345";"8587";"8758"
"Santo Antônio do Aventureiro (MG)";"Total";"Total";"3538";"1808";"1730"
"Santo Antônio do Grama (MG)";"Total";"Total";"4085";"2033";"2052"
"Santo Antônio do Itambé (MG)";"Total";"Total";"4135";"2068";"2067"
"Santo Antônio do Jacinto (MG)";"Total";"Total";"11775";"6027";"5748"
"Santo Antônio do Monte (MG)";"Total";"Total";"25975";"13197";"12778"
"Santo Antônio do Retiro (MG)";"Total";"Total";"6955";"3526";"3429"
"Santo Antônio do Rio Abaixo (MG)";"Total";"Total";"1777";"889";"888"
"Santo Hipólito (MG)";"Total";"Total";"3238";"1621";"1617"
"Santos Dumont (MG)";"Total";"Total";"46284";"22496";"23788"
"São Bento Abade (MG)";"Total";"Total";"4577";"2385";"2192"
"São Brás do Suaçuí (MG)";"Total";"Total";"3513";"1730";"1783"
"São Domingos das Dores (MG)";"Total";"Total";"5408";"2748";"2660"
"São Domingos do Prata (MG)";"Total";"Total";"17357";"8440";"8917"
"São Félix de Minas (MG)";"Total";"Total";"3382";"1734";"1648"
"São Francisco (MG)";"Total";"Total";"53828";"27278";"26550"
"São Francisco de Paula (MG)";"Total";"Total";"6483";"3280";"3203"
"São Francisco de Sales (MG)";"Total";"Total";"5776";"2972";"2804"
"São Francisco do Glória (MG)";"Total";"Total";"5178";"2655";"2523"
"São Geraldo (MG)";"Total";"Total";"10263";"5218";"5045"
"São Geraldo da Piedade (MG)";"Total";"Total";"4389";"2136";"2253"
"São Geraldo do Baixio (MG)";"Total";"Total";"3486";"1760";"1726"
"São Gonçalo do Abaeté (MG)";"Total";"Total";"6264";"3241";"3023"
"São Gonçalo do Pará (MG)";"Total";"Total";"10398";"5227";"5171"
"São Gonçalo do Rio Abaixo (MG)";"Total";"Total";"9777";"4872";"4905"
"São Gonçalo do Sapucaí (MG)";"Total";"Total";"23906";"11924";"11982"
"São Gotardo (MG)";"Total";"Total";"31819";"16096";"15723"
"São João Batista do Glória (MG)";"Total";"Total";"6887";"3558";"3329"
"São João da Lagoa (MG)";"Total";"Total";"4656";"2438";"2218"
"São João da Mata (MG)";"Total";"Total";"2731";"1400";"1331"
"São João da Ponte (MG)";"Total";"Total";"25358";"13123";"12235"
"São João das Missões (MG)";"Total";"Total";"11715";"6048";"5667"
"São João del Rei (MG)";"Total";"Total";"84469";"40549";"43920"
"São João do Manhuaçu (MG)";"Total";"Total";"10245";"5214";"5031"
"São João do Manteninha (MG)";"Total";"Total";"5188";"2555";"2633"
"São João do Oriente (MG)";"Total";"Total";"7874";"3907";"3967"
"São João do Pacuí (MG)";"Total";"Total";"4060";"2092";"1968"
"São João do Paraíso (MG)";"Total";"Total";"22319";"11163";"11156"
"São João Evangelista (MG)";"Total";"Total";"15553";"7614";"7939"
"São João Nepomuceno (MG)";"Total";"Total";"25057";"12181";"12876"
"São Joaquim de Bicas (MG)";"Total";"Total";"25537";"13741";"11796"
"São José da Barra (MG)";"Total";"Total";"6778";"3509";"3269"
"São José da Lapa (MG)";"Total";"Total";"19799";"9826";"9973"
"São José da Safira (MG)";"Total";"Total";"4075";"2027";"2048"
"São José da Varginha (MG)";"Total";"Total";"4198";"2133";"2065"
"São José do Alegre (MG)";"Total";"Total";"3996";"1976";"2020"
"São José do Divino (MG)";"Total";"Total";"3834";"1890";"1944"
"São José do Goiabal (MG)";"Total";"Total";"5636";"2732";"2904"
"São José do Jacuri (MG)";"Total";"Total";"6553";"3331";"3222"
"São José do Mantimento (MG)";"Total";"Total";"2592";"1291";"1301"
"São Lourenço (MG)";"Total";"Total";"41657";"19758";"21899"
"São Miguel do Anta (MG)";"Total";"Total";"6760";"3436";"3324"
"São Pedro da União (MG)";"Total";"Total";"5040";"2647";"2393"
"São Pedro dos Ferros (MG)";"Total";"Total";"8356";"4127";"4229"
"São Pedro do Suaçuí (MG)";"Total";"Total";"5570";"2746";"2824"
"São Romão (MG)";"Total";"Total";"10276";"5239";"5037"
"São Roque de Minas (MG)";"Total";"Total";"6686";"3483";"3203"
"São Sebastião da Bela Vista (MG)";"Total";"Total";"4948";"2579";"2369"
"São Sebastião da Vargem Alegre (MG)";"Total";"Total";"2798";"1459";"1339"
"São Sebastião do Anta (MG)";"Total";"Total";"5739";"2923";"2816"
"São Sebastião do Maranhão (MG)";"Total";"Total";"10647";"5371";"5276"
"São Sebastião do Oeste (MG)";"Total";"Total";"5805";"3030";"2775"
"São Sebastião do Paraíso (MG)";"Total";"Total";"64980";"32182";"32798"
"São Sebastião do Rio Preto (MG)";"Total";"Total";"1613";"772";"841"
"São Sebastião do Rio Verde (MG)";"Total";"Total";"2110";"1048";"1062"
"São Tiago (MG)";"Total";"Total";"10561";"5300";"5261"
"São Tomás de Aquino (MG)";"Total";"Total";"7093";"3558";"3535"
"São Thomé das Letras (MG)";"Total";"Total";"6655";"3539";"3116"
"São Vicente de Minas (MG)";"Total";"Total";"7008";"3394";"3614"
"Sapucaí-Mirim (MG)";"Total";"Total";"6241";"3204";"3037"
"Sardoá (MG)";"Total";"Total";"5594";"2814";"2780"
"Sarzedo (MG)";"Total";"Total";"25814";"12871";"12943"
"Setubinha (MG)";"Total";"Total";"10885";"5350";"5535"
"Sem-Peixe (MG)";"Total";"Total";"2847";"1404";"1443"
"Senador Amaral (MG)";"Total";"Total";"5219";"2776";"2443"
"Senador Cortes (MG)";"Total";"Total";"1988";"985";"1003"
"Senador Firmino (MG)";"Total";"Total";"7230";"3653";"3577"
"Senador José Bento (MG)";"Total";"Total";"1868";"1004";"864"
"Senador Modestino Gonçalves (MG)";"Total";"Total";"4574";"2317";"2257"
"Senhora de Oliveira (MG)";"Total";"Total";"5683";"2848";"2835"
"Senhora do Porto (MG)";"Total";"Total";"3497";"1765";"1732"
"Senhora dos Remédios (MG)";"Total";"Total";"10196";"5152";"5044"
"Sericita (MG)";"Total";"Total";"7128";"3647";"3481"
"Seritinga (MG)";"Total";"Total";"1789";"918";"871"
"Serra Azul de Minas (MG)";"Total";"Total";"4220";"2121";"2099"
"Serra da Saudade (MG)";"Total";"Total";"815";"430";"385"
"Serra dos Aimorés (MG)";"Total";"Total";"8412";"4172";"4240"
"Serra do Salitre (MG)";"Total";"Total";"10549";"5422";"5127"
"Serrania (MG)";"Total";"Total";"7542";"3803";"3739"
"Serranópolis de Minas (MG)";"Total";"Total";"4425";"2231";"2194"
"Serranos (MG)";"Total";"Total";"1995";"999";"996"
"Serro (MG)";"Total";"Total";"20835";"10374";"10461"
"Sete Lagoas (MG)";"Total";"Total";"214152";"103991";"110161"
"Silveirânia (MG)";"Total";"Total";"2192";"1148";"1044"
"Silvianópolis (MG)";"Total";"Total";"6027";"3128";"2899"
"Simão Pereira (MG)";"Total";"Total";"2537";"1248";"1289"
"Simonésia (MG)";"Total";"Total";"18298";"9466";"8832"
"Sobrália (MG)";"Total";"Total";"5830";"2857";"2973"
"Soledade de Minas (MG)";"Total";"Total";"5676";"2839";"2837"
"Tabuleiro (MG)";"Total";"Total";"4079";"2047";"2032"
"Taiobeiras (MG)";"Total";"Total";"30917";"15117";"15800"
"Taparuba (MG)";"Total";"Total";"3137";"1616";"1521"
"Tapira (MG)";"Total";"Total";"4112";"2214";"1898"
"Tapiraí (MG)";"Total";"Total";"1873";"1002";"871"
"Taquaraçu de Minas (MG)";"Total";"Total";"3794";"2027";"1767"
"Tarumirim (MG)";"Total";"Total";"14293";"7102";"7191"
"Teixeiras (MG)";"Total";"Total";"11355";"5543";"5812"
"Teófilo Otoni (MG)";"Total";"Total";"134745";"64466";"70279"
"Timóteo (MG)";"Total";"Total";"81243";"39193";"42050"
"Tiradentes (MG)";"Total";"Total";"6961";"3440";"3521"
"Tiros (MG)";"Total";"Total";"6906";"3537";"3369"
"Tocantins (MG)";"Total";"Total";"15823";"7894";"7929"
"Tocos do Moji (MG)";"Total";"Total";"3950";"2144";"1806"
"Toledo (MG)";"Total";"Total";"5764";"3043";"2721"
"Tombos (MG)";"Total";"Total";"9537";"4783";"4754"
"Três Corações (MG)";"Total";"Total";"72765";"36103";"36662"
"Três Marias (MG)";"Total";"Total";"28318";"14074";"14244"
"Três Pontas (MG)";"Total";"Total";"53860";"26705";"27155"
"Tumiritinga (MG)";"Total";"Total";"6293";"3198";"3095"
"Tupaciguara (MG)";"Total";"Total";"24188";"12084";"12104"
"Turmalina (MG)";"Total";"Total";"18055";"9168";"8887"
"Turvolândia (MG)";"Total";"Total";"4658";"2409";"2249"
"Ubá (MG)";"Total";"Total";"101519";"50258";"51261"
"Ubaí (MG)";"Total";"Total";"11681";"5979";"5702"
"Ubaporanga (MG)";"Total";"Total";"12040";"6085";"5955"
"Uberaba (MG)";"Total";"Total";"295988";"144461";"151527"
"Uberlândia (MG)";"Total";"Total";"604013";"294914";"309099"
"Umburatiba (MG)";"Total";"Total";"2705";"1399";"1306"
"Unaí (MG)";"Total";"Total";"77565";"39305";"38260"
"União de Minas (MG)";"Total";"Total";"4418";"2412";"2006"
"Uruana de Minas (MG)";"Total";"Total";"3235";"1627";"1608"
"Urucânia (MG)";"Total";"Total";"10291";"5085";"5206"
"Urucuia (MG)";"Total";"Total";"13604";"7030";"6574"
"Vargem Alegre (MG)";"Total";"Total";"6461";"3295";"3166"
"Vargem Bonita (MG)";"Total";"Total";"2163";"1145";"1018"
"Vargem Grande do Rio Pardo (MG)";"Total";"Total";"4733";"2428";"2305"
"Varginha (MG)";"Total";"Total";"123081";"59957";"63124"
"Varjão de Minas (MG)";"Total";"Total";"6054";"3170";"2884"
"Várzea da Palma (MG)";"Total";"Total";"35809";"18150";"17659"
"Varzelândia (MG)";"Total";"Total";"19116";"9765";"9351"
"Vazante (MG)";"Total";"Total";"19723";"9929";"9794"
"Verdelândia (MG)";"Total";"Total";"8346";"4274";"4072"
"Veredinha (MG)";"Total";"Total";"5549";"2891";"2658"
"Veríssimo (MG)";"Total";"Total";"3483";"1778";"1705"
"Vermelho Novo (MG)";"Total";"Total";"4689";"2427";"2262"
"Vespasiano (MG)";"Total";"Total";"104527";"51006";"53521"
"Viçosa (MG)";"Total";"Total";"72220";"35001";"37219"
"Vieiras (MG)";"Total";"Total";"3731";"1900";"1831"
"Mathias Lobato (MG)";"Total";"Total";"3370";"1675";"1695"
"Virgem da Lapa (MG)";"Total";"Total";"13619";"6763";"6856"
"Virgínia (MG)";"Total";"Total";"8623";"4308";"4315"
"Virginópolis (MG)";"Total";"Total";"10572";"5215";"5357"
"Virgolândia (MG)";"Total";"Total";"5658";"2788";"2870"
"Visconde do Rio Branco (MG)";"Total";"Total";"37942";"18701";"19241"
"Volta Grande (MG)";"Total";"Total";"5070";"2477";"2593"
"Wenceslau Braz (MG)";"Total";"Total";"2553";"1288";"1265"
"Afonso Cláudio (ES)";"Total";"Total";"31091";"15687";"15404"
"Águia Branca (ES)";"Total";"Total";"9519";"4901";"4618"
"Água Doce do Norte (ES)";"Total";"Total";"11771";"5960";"5811"
"Alegre (ES)";"Total";"Total";"30768";"15287";"15481"
"Alfredo Chaves (ES)";"Total";"Total";"13955";"7103";"6852"
"Alto Rio Novo (ES)";"Total";"Total";"7317";"3674";"3643"
"Anchieta (ES)";"Total";"Total";"23902";"12062";"11840"
"Apiacá (ES)";"Total";"Total";"7512";"3778";"3734"
"Aracruz (ES)";"Total";"Total";"81832";"40795";"41037"
"Atílio Vivácqua (ES)";"Total";"Total";"9850";"4999";"4851"
"Baixo Guandu (ES)";"Total";"Total";"29081";"14220";"14861"
"Barra de São Francisco (ES)";"Total";"Total";"40649";"20408";"20241"
"Boa Esperança (ES)";"Total";"Total";"14199";"7179";"7020"
"Bom Jesus do Norte (ES)";"Total";"Total";"9476";"4584";"4892"
"Brejetuba (ES)";"Total";"Total";"11915";"6211";"5704"
"Cachoeiro de Itapemirim (ES)";"Total";"Total";"189889";"92845";"97044"
"Cariacica (ES)";"Total";"Total";"348738";"169958";"178780"
"Castelo (ES)";"Total";"Total";"34747";"17401";"17346"
"Colatina (ES)";"Total";"Total";"111788";"54291";"57497"
"Conceição da Barra (ES)";"Total";"Total";"28449";"14161";"14288"
"Conceição do Castelo (ES)";"Total";"Total";"11681";"5938";"5743"
"Divino de São Lourenço (ES)";"Total";"Total";"4516";"2350";"2166"
"Domingos Martins (ES)";"Total";"Total";"31847";"16094";"15753"
"Dores do Rio Preto (ES)";"Total";"Total";"6397";"3226";"3171"
"Ecoporanga (ES)";"Total";"Total";"23212";"11566";"11646"
"Fundão (ES)";"Total";"Total";"17025";"8489";"8536"
"Governador Lindenberg (ES)";"Total";"Total";"10869";"5674";"5195"
"Guaçuí (ES)";"Total";"Total";"27851";"13686";"14165"
"Guarapari (ES)";"Total";"Total";"105286";"51494";"53792"
"Ibatiba (ES)";"Total";"Total";"22366";"11288";"11078"
"Ibiraçu (ES)";"Total";"Total";"11178";"5534";"5644"
"Ibitirama (ES)";"Total";"Total";"8957";"4649";"4308"
"Iconha (ES)";"Total";"Total";"12523";"6409";"6114"
"Irupi (ES)";"Total";"Total";"11723";"6030";"5693"
"Itaguaçu (ES)";"Total";"Total";"14134";"7197";"6937"
"Itapemirim (ES)";"Total";"Total";"30988";"15535";"15453"
"Itarana (ES)";"Total";"Total";"10881";"5456";"5425"
"Iúna (ES)";"Total";"Total";"27328";"13640";"13688"
"Jaguaré (ES)";"Total";"Total";"24678";"12468";"12210"
"Jerônimo Monteiro (ES)";"Total";"Total";"10879";"5292";"5587"
"João Neiva (ES)";"Total";"Total";"15809";"7811";"7998"
"Laranja da Terra (ES)";"Total";"Total";"10826";"5524";"5302"
"Linhares (ES)";"Total";"Total";"141306";"70415";"70891"
"Mantenópolis (ES)";"Total";"Total";"13612";"6805";"6807"
"Marataízes (ES)";"Total";"Total";"34140";"16876";"17264"
"Marechal Floriano (ES)";"Total";"Total";"14262";"7260";"7002"
"Marilândia (ES)";"Total";"Total";"11107";"5572";"5535"
"Mimoso do Sul (ES)";"Total";"Total";"25902";"13041";"12861"
"Montanha (ES)";"Total";"Total";"17849";"8974";"8875"
"Mucurici (ES)";"Total";"Total";"5655";"2871";"2784"
"Muniz Freire (ES)";"Total";"Total";"18397";"9303";"9094"
"Muqui (ES)";"Total";"Total";"14396";"7256";"7140"
"Nova Venécia (ES)";"Total";"Total";"46031";"23111";"22920"
"Pancas (ES)";"Total";"Total";"21548";"11001";"10547"
"Pedro Canário (ES)";"Total";"Total";"23794";"11901";"11893"
"Pinheiros (ES)";"Total";"Total";"23895";"12005";"11890"
"Piúma (ES)";"Total";"Total";"18123";"8956";"9167"
"Ponto Belo (ES)";"Total";"Total";"6979";"3493";"3486"
"Presidente Kennedy (ES)";"Total";"Total";"10314";"5258";"5056"
"Rio Bananal (ES)";"Total";"Total";"17530";"9079";"8451"
"Rio Novo do Sul (ES)";"Total";"Total";"11325";"5737";"5588"
"Santa Leopoldina (ES)";"Total";"Total";"12240";"6425";"5815"
"Santa Maria de Jetibá (ES)";"Total";"Total";"34176";"17532";"16644"
"Santa Teresa (ES)";"Total";"Total";"21823";"10915";"10908"
"São Domingos do Norte (ES)";"Total";"Total";"8001";"4164";"3837"
"São Gabriel da Palha (ES)";"Total";"Total";"31859";"15905";"15954"
"São José do Calçado (ES)";"Total";"Total";"10408";"5195";"5213"
"São Mateus (ES)";"Total";"Total";"109028";"53930";"55098"
"São Roque do Canaã (ES)";"Total";"Total";"11273";"5688";"5585"
"Serra (ES)";"Total";"Total";"409267";"201415";"207852"
"Sooretama (ES)";"Total";"Total";"23843";"12133";"11710"
"Vargem Alta (ES)";"Total";"Total";"19130";"9827";"9303"
"Venda Nova do Imigrante (ES)";"Total";"Total";"20447";"10335";"10112"
"Viana (ES)";"Total";"Total";"65001";"33191";"31810"
"Vila Pavão (ES)";"Total";"Total";"8672";"4493";"4179"
"Vila Valério (ES)";"Total";"Total";"13830";"7208";"6622"
"Vila Velha (ES)";"Total";"Total";"414586";"199146";"215440"
"Vitória (ES)";"Total";"Total";"327801";"153948";"173853"
"Angra dos Reis (RJ)";"Total";"Total";"169511";"84666";"84845"
"Aperibé (RJ)";"Total";"Total";"10213";"5023";"5190"
"Araruama (RJ)";"Total";"Total";"112008";"54283";"57725"
"Areal (RJ)";"Total";"Total";"11423";"5661";"5762"
"Armação dos Búzios (RJ)";"Total";"Total";"27560";"13742";"13818"
"Arraial do Cabo (RJ)";"Total";"Total";"27715";"13627";"14088"
"Barra do Piraí (RJ)";"Total";"Total";"94778";"45154";"49624"
"Barra Mansa (RJ)";"Total";"Total";"177813";"85792";"92021"
"Belford Roxo (RJ)";"Total";"Total";"469332";"226757";"242575"
"Bom Jardim (RJ)";"Total";"Total";"25333";"12720";"12613"
"Bom Jesus do Itabapoana (RJ)";"Total";"Total";"35411";"17196";"18215"
"Cabo Frio (RJ)";"Total";"Total";"186227";"90831";"95396"
"Cachoeiras de Macacu (RJ)";"Total";"Total";"54273";"27062";"27211"
"Cambuci (RJ)";"Total";"Total";"14827";"7407";"7420"
"Carapebus (RJ)";"Total";"Total";"13359";"6788";"6571"
"Comendador Levy Gasparian (RJ)";"Total";"Total";"8180";"4076";"4104"
"Campos dos Goytacazes (RJ)";"Total";"Total";"463731";"223259";"240472"
"Cantagalo (RJ)";"Total";"Total";"19830";"9831";"9999"
"Cardoso Moreira (RJ)";"Total";"Total";"12600";"6270";"6330"
"Carmo (RJ)";"Total";"Total";"17434";"8600";"8834"
"Casimiro de Abreu (RJ)";"Total";"Total";"35347";"17423";"17924"
"Conceição de Macabu (RJ)";"Total";"Total";"21211";"10549";"10662"
"Cordeiro (RJ)";"Total";"Total";"20430";"9781";"10649"
"Duas Barras (RJ)";"Total";"Total";"10930";"5511";"5419"
"Duque de Caxias (RJ)";"Total";"Total";"855048";"411074";"443974"
"Engenheiro Paulo de Frontin (RJ)";"Total";"Total";"13237";"6449";"6788"
"Guapimirim (RJ)";"Total";"Total";"51483";"25280";"26203"
"Iguaba Grande (RJ)";"Total";"Total";"22851";"11046";"11805"
"Itaboraí (RJ)";"Total";"Total";"218008";"106190";"111818"
"Itaguaí (RJ)";"Total";"Total";"109091";"54409";"54682"
"Italva (RJ)";"Total";"Total";"14063";"6853";"7210"
"Itaocara (RJ)";"Total";"Total";"22899";"11192";"11707"
"Itaperuna (RJ)";"Total";"Total";"95841";"46553";"49288"
"Itatiaia (RJ)";"Total";"Total";"28783";"14213";"14570"
"Japeri (RJ)";"Total";"Total";"95492";"48080";"47412"
"Laje do Muriaé (RJ)";"Total";"Total";"7487";"3751";"3736"
"Macaé (RJ)";"Total";"Total";"206728";"102432";"104296"
"Macuco (RJ)";"Total";"Total";"5269";"2528";"2741"
"Magé (RJ)";"Total";"Total";"227322";"110576";"116746"
"Mangaratiba (RJ)";"Total";"Total";"36456";"17962";"18494"
"Maricá (RJ)";"Total";"Total";"127461";"62649";"64812"
"Mendes (RJ)";"Total";"Total";"17935";"8651";"9284"
"Mesquita (RJ)";"Total";"Total";"168376";"79790";"88586"
"Miguel Pereira (RJ)";"Total";"Total";"24642";"11719";"12923"
"Miracema (RJ)";"Total";"Total";"26843";"13026";"13817"
"Natividade (RJ)";"Total";"Total";"15082";"7445";"7637"
"Nilópolis (RJ)";"Total";"Total";"157425";"73674";"83751"
"Niterói (RJ)";"Total";"Total";"487562";"225838";"261724"
"Nova Friburgo (RJ)";"Total";"Total";"182082";"87254";"94828"
"Nova Iguaçu (RJ)";"Total";"Total";"796257";"381750";"414507"
"Paracambi (RJ)";"Total";"Total";"47124";"23793";"23331"
"Paraíba do Sul (RJ)";"Total";"Total";"41084";"19751";"21333"
"Paraty (RJ)";"Total";"Total";"37533";"18964";"18569"
"Paty do Alferes (RJ)";"Total";"Total";"26359";"12817";"13542"
"Petrópolis (RJ)";"Total";"Total";"295917";"140996";"154921"
"Pinheiral (RJ)";"Total";"Total";"22719";"11034";"11685"
"Piraí (RJ)";"Total";"Total";"26314";"12917";"13397"
"Porciúncula (RJ)";"Total";"Total";"17760";"8874";"8886"
"Porto Real (RJ)";"Total";"Total";"16592";"8242";"8350"
"Quatis (RJ)";"Total";"Total";"12793";"6238";"6555"
"Queimados (RJ)";"Total";"Total";"137962";"66585";"71377"
"Quissamã (RJ)";"Total";"Total";"20242";"10043";"10199"
"Resende (RJ)";"Total";"Total";"119769";"58268";"61501"
"Rio Bonito (RJ)";"Total";"Total";"55551";"27318";"28233"
"Rio Claro (RJ)";"Total";"Total";"17425";"8769";"8656"
"Rio das Flores (RJ)";"Total";"Total";"8561";"4211";"4350"
"Rio das Ostras (RJ)";"Total";"Total";"105676";"52207";"53469"
"Rio de Janeiro (RJ)";"Total";"Total";"6320446";"2959817";"3360629"
"Santa Maria Madalena (RJ)";"Total";"Total";"10321";"5275";"5046"
"Santo Antônio de Pádua (RJ)";"Total";"Total";"40589";"19961";"20628"
"São Francisco de Itabapoana (RJ)";"Total";"Total";"41354";"20808";"20546"
"São Fidélis (RJ)";"Total";"Total";"37543";"18394";"19149"
"São Gonçalo (RJ)";"Total";"Total";"999728";"475264";"524464"
"São João da Barra (RJ)";"Total";"Total";"32747";"16229";"16518"
"São João de Meriti (RJ)";"Total";"Total";"458673";"218104";"240569"
"São José de Ubá (RJ)";"Total";"Total";"7003";"3498";"3505"
"São José do Vale do Rio Preto (RJ)";"Total";"Total";"20251";"10145";"10106"
"São Pedro da Aldeia (RJ)";"Total";"Total";"87875";"43431";"44444"
"São Sebastião do Alto (RJ)";"Total";"Total";"8895";"4467";"4428"
"Sapucaia (RJ)";"Total";"Total";"17525";"8766";"8759"
"Saquarema (RJ)";"Total";"Total";"74234";"36855";"37379"
"Seropédica (RJ)";"Total";"Total";"78186";"38433";"39753"
"Silva Jardim (RJ)";"Total";"Total";"21349";"10808";"10541"
"Sumidouro (RJ)";"Total";"Total";"14900";"7652";"7248"
"Tanguá (RJ)";"Total";"Total";"30732";"15289";"15443"
"Teresópolis (RJ)";"Total";"Total";"163746";"78275";"85471"
"Trajano de Moraes (RJ)";"Total";"Total";"10289";"5258";"5031"
"Três Rios (RJ)";"Total";"Total";"77432";"37014";"40418"
"Valença (RJ)";"Total";"Total";"71843";"34450";"37393"
"Varre-Sai (RJ)";"Total";"Total";"9475";"4756";"4719"
"Vassouras (RJ)";"Total";"Total";"34410";"16391";"18019"
"Volta Redonda (RJ)";"Total";"Total";"257803";"122919";"134884"
"Adamantina (SP)";"Total";"Total";"33797";"16374";"17423"
"Adolfo (SP)";"Total";"Total";"3557";"1787";"1770"
"Aguaí (SP)";"Total";"Total";"32148";"16217";"15931"
"Águas da Prata (SP)";"Total";"Total";"7584";"3747";"3837"
"Águas de Lindóia (SP)";"Total";"Total";"17266";"8457";"8809"
"Águas de Santa Bárbara (SP)";"Total";"Total";"5601";"2779";"2822"
"Águas de São Pedro (SP)";"Total";"Total";"2707";"1262";"1445"
"Agudos (SP)";"Total";"Total";"34524";"17076";"17448"
"Alambari (SP)";"Total";"Total";"4884";"2456";"2428"
"Alfredo Marcondes (SP)";"Total";"Total";"3891";"1981";"1910"
"Altair (SP)";"Total";"Total";"3815";"2051";"1764"
"Altinópolis (SP)";"Total";"Total";"15607";"7808";"7799"
"Alto Alegre (SP)";"Total";"Total";"4102";"2109";"1993"
"Alumínio (SP)";"Total";"Total";"16839";"8500";"8339"
"Álvares Florence (SP)";"Total";"Total";"3897";"1999";"1898"
"Álvares Machado (SP)";"Total";"Total";"23513";"11640";"11873"
"Álvaro de Carvalho (SP)";"Total";"Total";"4650";"2959";"1691"
"Alvinlândia (SP)";"Total";"Total";"3000";"1482";"1518"
"Americana (SP)";"Total";"Total";"210638";"103174";"107464"
"Américo Brasiliense (SP)";"Total";"Total";"34478";"17333";"17145"
"Américo de Campos (SP)";"Total";"Total";"5706";"2862";"2844"
"Amparo (SP)";"Total";"Total";"65829";"32442";"33387"
"Analândia (SP)";"Total";"Total";"4293";"2203";"2090"
"Andradina (SP)";"Total";"Total";"55334";"27190";"28144"
"Angatuba (SP)";"Total";"Total";"22210";"11245";"10965"
"Anhembi (SP)";"Total";"Total";"5653";"2909";"2744"
"Anhumas (SP)";"Total";"Total";"3738";"1863";"1875"
"Aparecida (SP)";"Total";"Total";"35007";"16898";"18109"
"Aparecida d'Oeste (SP)";"Total";"Total";"4450";"2177";"2273"
"Apiaí (SP)";"Total";"Total";"25191";"12577";"12614"
"Araçariguama (SP)";"Total";"Total";"17080";"8697";"8383"
"Araçatuba (SP)";"Total";"Total";"181579";"87329";"94250"
"Araçoiaba da Serra (SP)";"Total";"Total";"27299";"13607";"13692"
"Aramina (SP)";"Total";"Total";"5152";"2589";"2563"
"Arandu (SP)";"Total";"Total";"6123";"3088";"3035"
"Arapeí (SP)";"Total";"Total";"2493";"1255";"1238"
"Araraquara (SP)";"Total";"Total";"208662";"100655";"108007"
"Araras (SP)";"Total";"Total";"118843";"58688";"60155"
"Arco-Íris (SP)";"Total";"Total";"1925";"971";"954"
"Arealva (SP)";"Total";"Total";"7841";"3997";"3844"
"Areias (SP)";"Total";"Total";"3696";"1831";"1865"
"Areiópolis (SP)";"Total";"Total";"10579";"5453";"5126"
"Ariranha (SP)";"Total";"Total";"8547";"4366";"4181"
"Artur Nogueira (SP)";"Total";"Total";"44177";"22075";"22102"
"Arujá (SP)";"Total";"Total";"74905";"36939";"37966"
"Aspásia (SP)";"Total";"Total";"1809";"907";"902"
"Assis (SP)";"Total";"Total";"95144";"46317";"48827"
"Atibaia (SP)";"Total";"Total";"126603";"62211";"64392"
"Auriflama (SP)";"Total";"Total";"14202";"7102";"7100"
"Avaí (SP)";"Total";"Total";"4959";"2506";"2453"
"Avanhandava (SP)";"Total";"Total";"11310";"6249";"5061"
"Avaré (SP)";"Total";"Total";"82934";"41136";"41798"
"Bady Bassitt (SP)";"Total";"Total";"14603";"7249";"7354"
"Balbinos (SP)";"Total";"Total";"3702";"3002";"700"
"Bálsamo (SP)";"Total";"Total";"8160";"3998";"4162"
"Bananal (SP)";"Total";"Total";"10223";"5051";"5172"
"Barão de Antonina (SP)";"Total";"Total";"3116";"1591";"1525"
"Barbosa (SP)";"Total";"Total";"6593";"3323";"3270"
"Bariri (SP)";"Total";"Total";"31593";"15816";"15777"
"Barra Bonita (SP)";"Total";"Total";"35246";"17252";"17994"
"Barra do Chapéu (SP)";"Total";"Total";"5244";"2770";"2474"
"Barra do Turvo (SP)";"Total";"Total";"7729";"4050";"3679"
"Barretos (SP)";"Total";"Total";"112101";"54169";"57932"
"Barrinha (SP)";"Total";"Total";"28496";"14321";"14175"
"Barueri (SP)";"Total";"Total";"240749";"117051";"123698"
"Bastos (SP)";"Total";"Total";"20445";"10032";"10413"
"Batatais (SP)";"Total";"Total";"56476";"27744";"28732"
"Bauru (SP)";"Total";"Total";"343937";"166649";"177288"
"Bebedouro (SP)";"Total";"Total";"75035";"36529";"38506"
"Bento de Abreu (SP)";"Total";"Total";"2674";"1364";"1310"
"Bernardino de Campos (SP)";"Total";"Total";"10775";"5250";"5525"
"Bertioga (SP)";"Total";"Total";"47645";"23829";"23816"
"Bilac (SP)";"Total";"Total";"7048";"3491";"3557"
"Birigui (SP)";"Total";"Total";"108728";"53075";"55653"
"Biritiba Mirim (SP)";"Total";"Total";"28575";"14413";"14162"
"Boa Esperança do Sul (SP)";"Total";"Total";"13645";"6875";"6770"
"Bocaina (SP)";"Total";"Total";"10859";"5409";"5450"
"Bofete (SP)";"Total";"Total";"9618";"4906";"4712"
"Boituva (SP)";"Total";"Total";"48314";"24313";"24001"
"Bom Jesus dos Perdões (SP)";"Total";"Total";"19708";"9922";"9786"
"Bom Sucesso de Itararé (SP)";"Total";"Total";"3571";"1816";"1755"
"Borá (SP)";"Total";"Total";"805";"422";"383"
"Boracéia (SP)";"Total";"Total";"4268";"2178";"2090"
"Borborema (SP)";"Total";"Total";"14529";"7350";"7179"
"Borebi (SP)";"Total";"Total";"2293";"1143";"1150"
"Botucatu (SP)";"Total";"Total";"127328";"61761";"65567"
"Bragança Paulista (SP)";"Total";"Total";"146744";"72081";"74663"
"Braúna (SP)";"Total";"Total";"5021";"2552";"2469"
"Brejo Alegre (SP)";"Total";"Total";"2573";"1330";"1243"
"Brodowski (SP)";"Total";"Total";"21107";"10465";"10642"
"Brotas (SP)";"Total";"Total";"21580";"10711";"10869"
"Buri (SP)";"Total";"Total";"18563";"9501";"9062"
"Buritama (SP)";"Total";"Total";"15418";"7732";"7686"
"Buritizal (SP)";"Total";"Total";"4053";"2073";"1980"
"Cabrália Paulista (SP)";"Total";"Total";"4365";"2220";"2145"
"Cabreúva (SP)";"Total";"Total";"41604";"21080";"20524"
"Caçapava (SP)";"Total";"Total";"84752";"41996";"42756"
"Cachoeira Paulista (SP)";"Total";"Total";"30091";"14749";"15342"
"Caconde (SP)";"Total";"Total";"18538";"9285";"9253"
"Cafelândia (SP)";"Total";"Total";"16607";"8174";"8433"
"Caiabu (SP)";"Total";"Total";"4072";"2091";"1981"
"Caieiras (SP)";"Total";"Total";"86529";"42298";"44231"
"Caiuá (SP)";"Total";"Total";"5039";"2652";"2387"
"Cajamar (SP)";"Total";"Total";"64114";"31997";"32117"
"Cajati (SP)";"Total";"Total";"28372";"14328";"14044"
"Cajobi (SP)";"Total";"Total";"9768";"5025";"4743"
"Cajuru (SP)";"Total";"Total";"23371";"11699";"11672"
"Campina do Monte Alegre (SP)";"Total";"Total";"5567";"2853";"2714"
"Campinas (SP)";"Total";"Total";"1080113";"520865";"559248"
"Campo Limpo Paulista (SP)";"Total";"Total";"74074";"36392";"37682"
"Campos do Jordão (SP)";"Total";"Total";"47789";"23393";"24396"
"Campos Novos Paulista (SP)";"Total";"Total";"4539";"2339";"2200"
"Cananéia (SP)";"Total";"Total";"12226";"6134";"6092"
"Canas (SP)";"Total";"Total";"4385";"2223";"2162"
"Cândido Mota (SP)";"Total";"Total";"29884";"14658";"15226"
"Cândido Rodrigues (SP)";"Total";"Total";"2668";"1315";"1353"
"Canitar (SP)";"Total";"Total";"4369";"2216";"2153"
"Capão Bonito (SP)";"Total";"Total";"46178";"23021";"23157"
"Capela do Alto (SP)";"Total";"Total";"17532";"9038";"8494"
"Capivari (SP)";"Total";"Total";"48576";"24353";"24223"
"Caraguatatuba (SP)";"Total";"Total";"100840";"49959";"50881"
"Carapicuíba (SP)";"Total";"Total";"369584";"179284";"190300"
"Cardoso (SP)";"Total";"Total";"11805";"5830";"5975"
"Casa Branca (SP)";"Total";"Total";"28307";"14997";"13310"
"Cássia dos Coqueiros (SP)";"Total";"Total";"2634";"1347";"1287"
"Castilho (SP)";"Total";"Total";"18003";"8975";"9028"
"Catanduva (SP)";"Total";"Total";"112820";"54776";"58044"
"Catiguá (SP)";"Total";"Total";"7127";"3632";"3495"
"Cedral (SP)";"Total";"Total";"7972";"3977";"3995"
"Cerqueira César (SP)";"Total";"Total";"17532";"8673";"8859"
"Cerquilho (SP)";"Total";"Total";"39617";"19635";"19982"
"Cesário Lange (SP)";"Total";"Total";"15540";"8063";"7477"
"Charqueada (SP)";"Total";"Total";"15085";"7686";"7399"
"Clementina (SP)";"Total";"Total";"7065";"3661";"3404"
"Colina (SP)";"Total";"Total";"17371";"8626";"8745"
"Colômbia (SP)";"Total";"Total";"5994";"3066";"2928"
"Conchal (SP)";"Total";"Total";"25229";"12757";"12472"
"Conchas (SP)";"Total";"Total";"16288";"8191";"8097"
"Cordeirópolis (SP)";"Total";"Total";"21080";"10600";"10480"
"Coroados (SP)";"Total";"Total";"5238";"2610";"2628"
"Coronel Macedo (SP)";"Total";"Total";"5001";"2565";"2436"
"Corumbataí (SP)";"Total";"Total";"3874";"1974";"1900"
"Cosmópolis (SP)";"Total";"Total";"58827";"29410";"29417"
"Cosmorama (SP)";"Total";"Total";"7214";"3652";"3562"
"Cotia (SP)";"Total";"Total";"201150";"98455";"102695"
"Cravinhos (SP)";"Total";"Total";"31691";"15889";"15802"
"Cristais Paulista (SP)";"Total";"Total";"7588";"3874";"3714"
"Cruzália (SP)";"Total";"Total";"2274";"1110";"1164"
"Cruzeiro (SP)";"Total";"Total";"77039";"37505";"39534"
"Cubatão (SP)";"Total";"Total";"118720";"59229";"59491"
"Cunha (SP)";"Total";"Total";"21866";"11164";"10702"
"Descalvado (SP)";"Total";"Total";"31056";"15329";"15727"
"Diadema (SP)";"Total";"Total";"386089";"186803";"199286"
"Dirce Reis (SP)";"Total";"Total";"1689";"875";"814"
"Divinolândia (SP)";"Total";"Total";"11208";"5587";"5621"
"Dobrada (SP)";"Total";"Total";"7939";"4116";"3823"
"Dois Córregos (SP)";"Total";"Total";"24761";"12417";"12344"
"Dolcinópolis (SP)";"Total";"Total";"2096";"1091";"1005"
"Dourado (SP)";"Total";"Total";"8609";"4364";"4245"
"Dracena (SP)";"Total";"Total";"43258";"21405";"21853"
"Duartina (SP)";"Total";"Total";"12251";"5970";"6281"
"Dumont (SP)";"Total";"Total";"8143";"4096";"4047"
"Echaporã (SP)";"Total";"Total";"6318";"3115";"3203"
"Eldorado (SP)";"Total";"Total";"14641";"7478";"7163"
"Elias Fausto (SP)";"Total";"Total";"15775";"8168";"7607"
"Elisiário (SP)";"Total";"Total";"3120";"1650";"1470"
"Embaúba (SP)";"Total";"Total";"2423";"1259";"1164"
"Embu das Artes (SP)";"Total";"Total";"240230";"116728";"123502"
"Embu-Guaçu (SP)";"Total";"Total";"62769";"31186";"31583"
"Emilianópolis (SP)";"Total";"Total";"3020";"1517";"1503"
"Engenheiro Coelho (SP)";"Total";"Total";"15721";"8233";"7488"
"Espírito Santo do Pinhal (SP)";"Total";"Total";"41907";"20507";"21400"
"Espírito Santo do Turvo (SP)";"Total";"Total";"4244";"2145";"2099"
"Estrela d'Oeste (SP)";"Total";"Total";"8208";"4133";"4075"
"Estrela do Norte (SP)";"Total";"Total";"2658";"1370";"1288"
"Euclides da Cunha Paulista (SP)";"Total";"Total";"9585";"4832";"4753"
"Fartura (SP)";"Total";"Total";"15320";"7426";"7894"
"Fernandópolis (SP)";"Total";"Total";"64696";"31518";"33178"
"Fernando Prestes (SP)";"Total";"Total";"5534";"2726";"2808"
"Fernão (SP)";"Total";"Total";"1563";"794";"769"
"Ferraz de Vasconcelos (SP)";"Total";"Total";"168306";"82143";"86163"
"Flora Rica (SP)";"Total";"Total";"1752";"880";"872"
"Floreal (SP)";"Total";"Total";"3003";"1496";"1507"
"Flórida Paulista (SP)";"Total";"Total";"12848";"7055";"5793"
"Florínea (SP)";"Total";"Total";"2829";"1383";"1446"
"Franca (SP)";"Total";"Total";"318640";"155464";"163176"
"Francisco Morato (SP)";"Total";"Total";"154472";"76636";"77836"
"Franco da Rocha (SP)";"Total";"Total";"131604";"67462";"64142"
"Gabriel Monteiro (SP)";"Total";"Total";"2708";"1375";"1333"
"Gália (SP)";"Total";"Total";"7011";"3506";"3505"
"Garça (SP)";"Total";"Total";"43115";"20970";"22145"
"Gastão Vidigal (SP)";"Total";"Total";"4193";"2298";"1895"
"Gavião Peixoto (SP)";"Total";"Total";"4419";"2284";"2135"
"General Salgado (SP)";"Total";"Total";"10669";"5352";"5317"
"Getulina (SP)";"Total";"Total";"10765";"5861";"4904"
"Glicério (SP)";"Total";"Total";"4565";"2289";"2276"
"Guaiçara (SP)";"Total";"Total";"10670";"5367";"5303"
"Guaimbê (SP)";"Total";"Total";"5425";"2697";"2728"
"Guaíra (SP)";"Total";"Total";"37404";"18520";"18884"
"Guapiaçu (SP)";"Total";"Total";"17869";"9029";"8840"
"Guapiara (SP)";"Total";"Total";"17998";"9153";"8845"
"Guará (SP)";"Total";"Total";"19858";"9884";"9974"
"Guaraçaí (SP)";"Total";"Total";"8435";"4195";"4240"
"Guaraci (SP)";"Total";"Total";"9976";"5084";"4892"
"Guarani d'Oeste (SP)";"Total";"Total";"1970";"963";"1007"
"Guarantã (SP)";"Total";"Total";"6404";"3218";"3186"
"Guararapes (SP)";"Total";"Total";"30597";"15091";"15506"
"Guararema (SP)";"Total";"Total";"25844";"12998";"12846"
"Guaratinguetá (SP)";"Total";"Total";"112072";"53946";"58126"
"Guareí (SP)";"Total";"Total";"14565";"8927";"5638"
"Guariba (SP)";"Total";"Total";"35486";"17912";"17574"
"Guarujá (SP)";"Total";"Total";"290752";"141711";"149041"
"Guarulhos (SP)";"Total";"Total";"1221979";"595043";"626936"
"Guatapará (SP)";"Total";"Total";"6966";"3579";"3387"
"Guzolândia (SP)";"Total";"Total";"4754";"2436";"2318"
"Herculândia (SP)";"Total";"Total";"8696";"4351";"4345"
"Holambra (SP)";"Total";"Total";"11299";"5725";"5574"
"Hortolândia (SP)";"Total";"Total";"192692";"97439";"95253"
"Iacanga (SP)";"Total";"Total";"10013";"5164";"4849"
"Iacri (SP)";"Total";"Total";"6419";"3249";"3170"
"Iaras (SP)";"Total";"Total";"6376";"4196";"2180"
"Ibaté (SP)";"Total";"Total";"30734";"15814";"14920"
"Ibirá (SP)";"Total";"Total";"10896";"5414";"5482"
"Ibirarema (SP)";"Total";"Total";"6725";"3395";"3330"
"Ibitinga (SP)";"Total";"Total";"53158";"26212";"26946"
"Ibiúna (SP)";"Total";"Total";"71217";"36216";"35001"
"Icém (SP)";"Total";"Total";"7462";"3795";"3667"
"Iepê (SP)";"Total";"Total";"7628";"3779";"3849"
"Igaraçu do Tietê (SP)";"Total";"Total";"23362";"11653";"11709"
"Igarapava (SP)";"Total";"Total";"27952";"13842";"14110"
"Igaratá (SP)";"Total";"Total";"8831";"4522";"4309"
"Iguape (SP)";"Total";"Total";"28841";"14462";"14379"
"Ilhabela (SP)";"Total";"Total";"28196";"14329";"13867"
"Ilha Comprida (SP)";"Total";"Total";"9025";"4475";"4550"
"Ilha Solteira (SP)";"Total";"Total";"25064";"12199";"12865"
"Indaiatuba (SP)";"Total";"Total";"201619";"100178";"101441"
"Indiana (SP)";"Total";"Total";"4825";"2423";"2402"
"Indiaporã (SP)";"Total";"Total";"3903";"1920";"1983"
"Inúbia Paulista (SP)";"Total";"Total";"3630";"1821";"1809"
"Ipaussu (SP)";"Total";"Total";"13663";"6893";"6770"
"Iperó (SP)";"Total";"Total";"28300";"15209";"13091"
"Ipeúna (SP)";"Total";"Total";"6016";"3110";"2906"
"Ipiguá (SP)";"Total";"Total";"4463";"2267";"2196"
"Iporanga (SP)";"Total";"Total";"4299";"2171";"2128"
"Ipuã (SP)";"Total";"Total";"14148";"7210";"6938"
"Iracemápolis (SP)";"Total";"Total";"20029";"10046";"9983"
"Irapuã (SP)";"Total";"Total";"7275";"3803";"3472"
"Irapuru (SP)";"Total";"Total";"7789";"4532";"3257"
"Itaberá (SP)";"Total";"Total";"17858";"9016";"8842"
"Itaí (SP)";"Total";"Total";"24008";"12761";"11247"
"Itajobi (SP)";"Total";"Total";"14556";"7349";"7207"
"Itaju (SP)";"Total";"Total";"3246";"1705";"1541"
"Itanhaém (SP)";"Total";"Total";"87057";"42192";"44865"
"Itaoca (SP)";"Total";"Total";"3228";"1687";"1541"
"Itapecerica da Serra (SP)";"Total";"Total";"152614";"76270";"76344"
"Itapetininga (SP)";"Total";"Total";"144377";"72167";"72210"
"Itapeva (SP)";"Total";"Total";"87753";"43243";"44510"
"Itapevi (SP)";"Total";"Total";"200769";"98746";"102023"
"Itapira (SP)";"Total";"Total";"68537";"33950";"34587"
"Itapirapuã Paulista (SP)";"Total";"Total";"3880";"2002";"1878"
"Itápolis (SP)";"Total";"Total";"40051";"19867";"20184"
"Itaporanga (SP)";"Total";"Total";"14549";"7280";"7269"
"Itapuí (SP)";"Total";"Total";"12173";"6150";"6023"
"Itapura (SP)";"Total";"Total";"4357";"2257";"2100"
"Itaquaquecetuba (SP)";"Total";"Total";"321770";"158542";"163228"
"Itararé (SP)";"Total";"Total";"47934";"23523";"24411"
"Itariri (SP)";"Total";"Total";"15471";"7794";"7677"
"Itatiba (SP)";"Total";"Total";"101471";"50147";"51324"
"Itatinga (SP)";"Total";"Total";"18052";"9230";"8822"
"Itirapina (SP)";"Total";"Total";"15524";"9154";"6370"
"Itirapuã (SP)";"Total";"Total";"5914";"3013";"2901"
"Itobi (SP)";"Total";"Total";"7546";"3908";"3638"
"Itu (SP)";"Total";"Total";"154147";"76219";"77928"
"Itupeva (SP)";"Total";"Total";"44859";"22793";"22066"
"Ituverava (SP)";"Total";"Total";"38695";"18874";"19821"
"Jaborandi (SP)";"Total";"Total";"6592";"3338";"3254"
"Jaboticabal (SP)";"Total";"Total";"71662";"34794";"36868"
"Jacareí (SP)";"Total";"Total";"211214";"103092";"108122"
"Jaci (SP)";"Total";"Total";"5657";"2892";"2765"
"Jacupiranga (SP)";"Total";"Total";"17208";"8777";"8431"
"Jaguariúna (SP)";"Total";"Total";"44311";"22004";"22307"
"Jales (SP)";"Total";"Total";"47012";"22986";"24026"
"Jambeiro (SP)";"Total";"Total";"5349";"2769";"2580"
"Jandira (SP)";"Total";"Total";"108344";"53063";"55281"
"Jardinópolis (SP)";"Total";"Total";"37661";"18949";"18712"
"Jarinu (SP)";"Total";"Total";"23847";"12005";"11842"
"Jaú (SP)";"Total";"Total";"131040";"64214";"66826"
"Jeriquara (SP)";"Total";"Total";"3160";"1622";"1538"
"Joanópolis (SP)";"Total";"Total";"11768";"5927";"5841"
"João Ramalho (SP)";"Total";"Total";"4150";"2098";"2052"
"José Bonifácio (SP)";"Total";"Total";"32763";"16351";"16412"
"Júlio Mesquita (SP)";"Total";"Total";"4430";"2179";"2251"
"Jumirim (SP)";"Total";"Total";"2798";"1444";"1354"
"Jundiaí (SP)";"Total";"Total";"370126";"180049";"190077"
"Junqueirópolis (SP)";"Total";"Total";"18726";"9921";"8805"
"Juquiá (SP)";"Total";"Total";"19246";"9740";"9506"
"Juquitiba (SP)";"Total";"Total";"28737";"14543";"14194"
"Lagoinha (SP)";"Total";"Total";"4841";"2479";"2362"
"Laranjal Paulista (SP)";"Total";"Total";"25251";"12465";"12786"
"Lavínia (SP)";"Total";"Total";"8779";"6183";"2596"
"Lavrinhas (SP)";"Total";"Total";"6590";"3320";"3270"
"Leme (SP)";"Total";"Total";"91756";"46030";"45726"
"Lençóis Paulista (SP)";"Total";"Total";"61428";"30498";"30930"
"Limeira (SP)";"Total";"Total";"276022";"135628";"140394"
"Lindóia (SP)";"Total";"Total";"6712";"3326";"3386"
"Lins (SP)";"Total";"Total";"71432";"34681";"36751"
"Lorena (SP)";"Total";"Total";"82537";"39858";"42679"
"Lourdes (SP)";"Total";"Total";"2128";"1107";"1021"
"Louveira (SP)";"Total";"Total";"37125";"18801";"18324"
"Lucélia (SP)";"Total";"Total";"19882";"10559";"9323"
"Lucianópolis (SP)";"Total";"Total";"2249";"1118";"1131"
"Luís Antônio (SP)";"Total";"Total";"11286";"5832";"5454"
"Luiziânia (SP)";"Total";"Total";"5030";"2612";"2418"
"Lupércio (SP)";"Total";"Total";"4353";"2121";"2232"
"Lutécia (SP)";"Total";"Total";"2714";"1354";"1360"
"Macatuba (SP)";"Total";"Total";"16259";"8152";"8107"
"Macaubal (SP)";"Total";"Total";"7663";"3880";"3783"
"Macedônia (SP)";"Total";"Total";"3664";"1837";"1827"
"Magda (SP)";"Total";"Total";"3200";"1651";"1549"
"Mairinque (SP)";"Total";"Total";"43223";"21538";"21685"
"Mairiporã (SP)";"Total";"Total";"80956";"40975";"39981"
"Manduri (SP)";"Total";"Total";"8992";"4519";"4473"
"Marabá Paulista (SP)";"Total";"Total";"4812";"3048";"1764"
"Maracaí (SP)";"Total";"Total";"13332";"6663";"6669"
"Marapoama (SP)";"Total";"Total";"2633";"1349";"1284"
"Mariápolis (SP)";"Total";"Total";"3916";"2021";"1895"
"Marília (SP)";"Total";"Total";"216745";"104726";"112019"
"Marinópolis (SP)";"Total";"Total";"2113";"1063";"1050"
"Martinópolis (SP)";"Total";"Total";"24219";"12601";"11618"
"Matão (SP)";"Total";"Total";"76786";"38033";"38753"
"Mauá (SP)";"Total";"Total";"417064";"204093";"212971"
"Mendonça (SP)";"Total";"Total";"4640";"2357";"2283"
"Meridiano (SP)";"Total";"Total";"3855";"1892";"1963"
"Mesópolis (SP)";"Total";"Total";"1886";"957";"929"
"Miguelópolis (SP)";"Total";"Total";"20451";"10204";"10247"
"Mineiros do Tietê (SP)";"Total";"Total";"12038";"5992";"6046"
"Miracatu (SP)";"Total";"Total";"20592";"10412";"10180"
"Mira Estrela (SP)";"Total";"Total";"2820";"1401";"1419"
"Mirandópolis (SP)";"Total";"Total";"27483";"15055";"12428"
"Mirante do Paranapanema (SP)";"Total";"Total";"17059";"8663";"8396"
"Mirassol (SP)";"Total";"Total";"53792";"26402";"27390"
"Mirassolândia (SP)";"Total";"Total";"4295";"2193";"2102"
"Mococa (SP)";"Total";"Total";"66290";"33059";"33231"
"Mogi das Cruzes (SP)";"Total";"Total";"387779";"188857";"198922"
"Mogi Guaçu (SP)";"Total";"Total";"137245";"68094";"69151"
"Mogi Mirim (SP)";"Total";"Total";"86505";"42597";"43908"
"Mombuca (SP)";"Total";"Total";"3266";"1663";"1603"
"Monções (SP)";"Total";"Total";"2132";"1101";"1031"
"Mongaguá (SP)";"Total";"Total";"46293";"23098";"23195"
"Monte Alegre do Sul (SP)";"Total";"Total";"7152";"3581";"3571"
"Monte Alto (SP)";"Total";"Total";"46642";"22978";"23664"
"Monte Aprazível (SP)";"Total";"Total";"21746";"10814";"10932"
"Monte Azul Paulista (SP)";"Total";"Total";"18931";"9491";"9440"
"Monte Castelo (SP)";"Total";"Total";"4063";"2011";"2052"
"Monteiro Lobato (SP)";"Total";"Total";"4120";"2150";"1970"
"Monte Mor (SP)";"Total";"Total";"48949";"24472";"24477"
"Morro Agudo (SP)";"Total";"Total";"29116";"14879";"14237"
"Morungaba (SP)";"Total";"Total";"11769";"5895";"5874"
"Motuca (SP)";"Total";"Total";"4290";"2162";"2128"
"Murutinga do Sul (SP)";"Total";"Total";"4186";"2097";"2089"
"Nantes (SP)";"Total";"Total";"2707";"1357";"1350"
"Narandiba (SP)";"Total";"Total";"4288";"2170";"2118"
"Natividade da Serra (SP)";"Total";"Total";"6678";"3486";"3192"
"Nazaré Paulista (SP)";"Total";"Total";"16414";"8454";"7960"
"Neves Paulista (SP)";"Total";"Total";"8772";"4363";"4409"
"Nhandeara (SP)";"Total";"Total";"10725";"5281";"5444"
"Nipoã (SP)";"Total";"Total";"4274";"2262";"2012"
"Nova Aliança (SP)";"Total";"Total";"5891";"2922";"2969"
"Nova Campina (SP)";"Total";"Total";"8515";"4345";"4170"
"Nova Canaã Paulista (SP)";"Total";"Total";"2114";"1076";"1038"
"Nova Castilho (SP)";"Total";"Total";"1125";"556";"569"
"Nova Europa (SP)";"Total";"Total";"9300";"4649";"4651"
"Nova Granada (SP)";"Total";"Total";"19180";"9659";"9521"
"Nova Guataporanga (SP)";"Total";"Total";"2177";"1102";"1075"
"Nova Independência (SP)";"Total";"Total";"3068";"1525";"1543"
"Novais (SP)";"Total";"Total";"4592";"2479";"2113"
"Nova Luzitânia (SP)";"Total";"Total";"3441";"1820";"1621"
"Nova Odessa (SP)";"Total";"Total";"51242";"25345";"25897"
"Novo Horizonte (SP)";"Total";"Total";"36593";"18271";"18322"
"Nuporanga (SP)";"Total";"Total";"6817";"3410";"3407"
"Ocauçu (SP)";"Total";"Total";"4163";"2137";"2026"
"Óleo (SP)";"Total";"Total";"2673";"1344";"1329"
"Olímpia (SP)";"Total";"Total";"50024";"24685";"25339"
"Onda Verde (SP)";"Total";"Total";"3884";"1993";"1891"
"Oriente (SP)";"Total";"Total";"6097";"2985";"3112"
"Orindiúva (SP)";"Total";"Total";"5675";"2899";"2776"
"Orlândia (SP)";"Total";"Total";"39781";"19495";"20286"
"Osasco (SP)";"Total";"Total";"666740";"320436";"346304"
"Oscar Bressane (SP)";"Total";"Total";"2537";"1217";"1320"
"Osvaldo Cruz (SP)";"Total";"Total";"30917";"15554";"15363"
"Ourinhos (SP)";"Total";"Total";"103035";"49981";"53054"
"Ouroeste (SP)";"Total";"Total";"8405";"4190";"4215"
"Ouro Verde (SP)";"Total";"Total";"7800";"3866";"3934"
"Pacaembu (SP)";"Total";"Total";"13226";"7744";"5482"
"Palestina (SP)";"Total";"Total";"11051";"5595";"5456"
"Palmares Paulista (SP)";"Total";"Total";"10934";"5861";"5073"
"Palmeira d'Oeste (SP)";"Total";"Total";"9584";"4805";"4779"
"Palmital (SP)";"Total";"Total";"21186";"10353";"10833"
"Panorama (SP)";"Total";"Total";"14583";"7312";"7271"
"Paraguaçu Paulista (SP)";"Total";"Total";"42278";"21259";"21019"
"Paraibuna (SP)";"Total";"Total";"17388";"8837";"8551"
"Paraíso (SP)";"Total";"Total";"5898";"3012";"2886"
"Paranapanema (SP)";"Total";"Total";"17808";"9062";"8746"
"Paranapuã (SP)";"Total";"Total";"3815";"1950";"1865"
"Parapuã (SP)";"Total";"Total";"10844";"5535";"5309"
"Pardinho (SP)";"Total";"Total";"5582";"2844";"2738"
"Pariquera-Açu (SP)";"Total";"Total";"18446";"9138";"9308"
"Parisi (SP)";"Total";"Total";"2032";"1044";"988"
"Patrocínio Paulista (SP)";"Total";"Total";"13000";"6596";"6404"
"Paulicéia (SP)";"Total";"Total";"6339";"3290";"3049"
"Paulínia (SP)";"Total";"Total";"82146";"40668";"41478"
"Paulistânia (SP)";"Total";"Total";"1779";"919";"860"
"Paulo de Faria (SP)";"Total";"Total";"8589";"4299";"4290"
"Pederneiras (SP)";"Total";"Total";"41497";"20861";"20636"
"Pedra Bela (SP)";"Total";"Total";"5780";"3030";"2750"
"Pedranópolis (SP)";"Total";"Total";"2558";"1314";"1244"
"Pedregulho (SP)";"Total";"Total";"15700";"7985";"7715"
"Pedreira (SP)";"Total";"Total";"41558";"20605";"20953"
"Pedrinhas Paulista (SP)";"Total";"Total";"2940";"1463";"1477"
"Pedro de Toledo (SP)";"Total";"Total";"10204";"5156";"5048"
"Penápolis (SP)";"Total";"Total";"58510";"28568";"29942"
"Pereira Barreto (SP)";"Total";"Total";"24962";"12270";"12692"
"Pereiras (SP)";"Total";"Total";"7454";"3786";"3668"
"Peruíbe (SP)";"Total";"Total";"59773";"29140";"30633"
"Piacatu (SP)";"Total";"Total";"5287";"2662";"2625"
"Piedade (SP)";"Total";"Total";"52143";"26578";"25565"
"Pilar do Sul (SP)";"Total";"Total";"26406";"13415";"12991"
"Pindamonhangaba (SP)";"Total";"Total";"146995";"72288";"74707"
"Pindorama (SP)";"Total";"Total";"15039";"7692";"7347"
"Pinhalzinho (SP)";"Total";"Total";"13105";"6593";"6512"
"Piquerobi (SP)";"Total";"Total";"3537";"1753";"1784"
"Piquete (SP)";"Total";"Total";"14107";"6817";"7290"
"Piracaia (SP)";"Total";"Total";"25116";"12514";"12602"
"Piracicaba (SP)";"Total";"Total";"364571";"178345";"186226"
"Piraju (SP)";"Total";"Total";"28475";"13826";"14649"
"Pirajuí (SP)";"Total";"Total";"22704";"12570";"10134"
"Pirangi (SP)";"Total";"Total";"10623";"5393";"5230"
"Pirapora do Bom Jesus (SP)";"Total";"Total";"15733";"7818";"7915"
"Pirapozinho (SP)";"Total";"Total";"24694";"12082";"12612"
"Pirassununga (SP)";"Total";"Total";"70081";"34297";"35784"
"Piratininga (SP)";"Total";"Total";"12072";"5986";"6086"
"Pitangueiras (SP)";"Total";"Total";"35307";"18009";"17298"
"Planalto (SP)";"Total";"Total";"4463";"2313";"2150"
"Platina (SP)";"Total";"Total";"3192";"1660";"1532"
"Poá (SP)";"Total";"Total";"106013";"51292";"54721"
"Poloni (SP)";"Total";"Total";"5395";"2671";"2724"
"Pompéia (SP)";"Total";"Total";"19964";"9793";"10171"
"Pongaí (SP)";"Total";"Total";"3481";"1793";"1688"
"Pontal (SP)";"Total";"Total";"40244";"21175";"19069"
"Pontalinda (SP)";"Total";"Total";"4074";"2160";"1914"
"Pontes Gestal (SP)";"Total";"Total";"2518";"1256";"1262"
"Populina (SP)";"Total";"Total";"4223";"2139";"2084"
"Porangaba (SP)";"Total";"Total";"8326";"4276";"4050"
"Porto Feliz (SP)";"Total";"Total";"48893";"24535";"24358"
"Porto Ferreira (SP)";"Total";"Total";"51400";"25502";"25898"
"Potim (SP)";"Total";"Total";"19397";"10974";"8423"
"Potirendaba (SP)";"Total";"Total";"15449";"7852";"7597"
"Pracinha (SP)";"Total";"Total";"2858";"2080";"778"
"Pradópolis (SP)";"Total";"Total";"17377";"8882";"8495"
"Praia Grande (SP)";"Total";"Total";"262051";"125926";"136125"
"Pratânia (SP)";"Total";"Total";"4599";"2379";"2220"
"Presidente Alves (SP)";"Total";"Total";"4123";"2038";"2085"
"Presidente Bernardes (SP)";"Total";"Total";"13570";"6683";"6887"
"Presidente Epitácio (SP)";"Total";"Total";"41318";"20217";"21101"
"Presidente Prudente (SP)";"Total";"Total";"207610";"99894";"107716"
"Presidente Venceslau (SP)";"Total";"Total";"37910";"18911";"18999"
"Promissão (SP)";"Total";"Total";"35674";"17756";"17918"
"Quadra (SP)";"Total";"Total";"3236";"1707";"1529"
"Quatá (SP)";"Total";"Total";"12799";"6393";"6406"
"Queiroz (SP)";"Total";"Total";"2808";"1424";"1384"
"Queluz (SP)";"Total";"Total";"11309";"5757";"5552"
"Quintana (SP)";"Total";"Total";"6004";"2969";"3035"
"Rafard (SP)";"Total";"Total";"8612";"4257";"4355"
"Rancharia (SP)";"Total";"Total";"28804";"14153";"14651"
"Redenção da Serra (SP)";"Total";"Total";"3873";"2017";"1856"
"Regente Feijó (SP)";"Total";"Total";"18494";"9188";"9306"
"Reginópolis (SP)";"Total";"Total";"7323";"4681";"2642"
"Registro (SP)";"Total";"Total";"54261";"26656";"27605"
"Restinga (SP)";"Total";"Total";"6587";"3296";"3291"
"Ribeira (SP)";"Total";"Total";"3358";"1743";"1615"
"Ribeirão Bonito (SP)";"Total";"Total";"12135";"6104";"6031"
"Ribeirão Branco (SP)";"Total";"Total";"18269";"9396";"8873"
"Ribeirão Corrente (SP)";"Total";"Total";"4273";"2218";"2055"
"Ribeirão do Sul (SP)";"Total";"Total";"4446";"2231";"2215"
"Ribeirão dos Índios (SP)";"Total";"Total";"2187";"1089";"1098"
"Ribeirão Grande (SP)";"Total";"Total";"7422";"3795";"3627"
"Ribeirão Pires (SP)";"Total";"Total";"113068";"55318";"57750"
"Ribeirão Preto (SP)";"Total";"Total";"604682";"290171";"314511"
"Riversul (SP)";"Total";"Total";"6163";"3047";"3116"
"Rifaina (SP)";"Total";"Total";"3436";"1724";"1712"
"Rincão (SP)";"Total";"Total";"10414";"5244";"5170"
"Rinópolis (SP)";"Total";"Total";"9935";"5051";"4884"
"Rio Claro (SP)";"Total";"Total";"186253";"90687";"95566"
"Rio das Pedras (SP)";"Total";"Total";"29501";"14914";"14587"
"Rio Grande da Serra (SP)";"Total";"Total";"43974";"21804";"22170"
"Riolândia (SP)";"Total";"Total";"10575";"6022";"4553"
"Rosana (SP)";"Total";"Total";"19691";"9780";"9911"
"Roseira (SP)";"Total";"Total";"9599";"4842";"4757"
"Rubiácea (SP)";"Total";"Total";"2729";"1392";"1337"
"Rubinéia (SP)";"Total";"Total";"2862";"1415";"1447"
"Sabino (SP)";"Total";"Total";"5217";"2623";"2594"
"Sagres (SP)";"Total";"Total";"2395";"1191";"1204"
"Sales (SP)";"Total";"Total";"5451";"2789";"2662"
"Sales Oliveira (SP)";"Total";"Total";"10568";"5241";"5327"
"Salesópolis (SP)";"Total";"Total";"15635";"7906";"7729"
"Salmourão (SP)";"Total";"Total";"4818";"2477";"2341"
"Saltinho (SP)";"Total";"Total";"7059";"3519";"3540"
"Salto (SP)";"Total";"Total";"105516";"52132";"53384"
"Salto de Pirapora (SP)";"Total";"Total";"40132";"19949";"20183"
"Salto Grande (SP)";"Total";"Total";"8787";"4353";"4434"
"Sandovalina (SP)";"Total";"Total";"3699";"1885";"1814"
"Santa Adélia (SP)";"Total";"Total";"14333";"7164";"7169"
"Santa Albertina (SP)";"Total";"Total";"5723";"2905";"2818"
"Santa Bárbara d'Oeste (SP)";"Total";"Total";"180009";"89222";"90787"
"Santa Branca (SP)";"Total";"Total";"13763";"6875";"6888"
"Santa Clara d'Oeste (SP)";"Total";"Total";"2084";"1073";"1011"
"Santa Cruz da Conceição (SP)";"Total";"Total";"4002";"1980";"2022"
"Santa Cruz da Esperança (SP)";"Total";"Total";"1953";"966";"987"
"Santa Cruz das Palmeiras (SP)";"Total";"Total";"29932";"15222";"14710"
"Santa Cruz do Rio Pardo (SP)";"Total";"Total";"43921";"21512";"22409"
"Santa Ernestina (SP)";"Total";"Total";"5568";"2852";"2716"
"Santa Fé do Sul (SP)";"Total";"Total";"29239";"14084";"15155"
"Santa Gertrudes (SP)";"Total";"Total";"21634";"10954";"10680"
"Santa Isabel (SP)";"Total";"Total";"50453";"25248";"25205"
"Santa Lúcia (SP)";"Total";"Total";"8248";"4130";"4118"
"Santa Maria da Serra (SP)";"Total";"Total";"5413";"2746";"2667"
"Santa Mercedes (SP)";"Total";"Total";"2831";"1423";"1408"
"Santana da Ponte Pensa (SP)";"Total";"Total";"1641";"841";"800"
"Santana de Parnaíba (SP)";"Total";"Total";"108813";"53671";"55142"
"Santa Rita d'Oeste (SP)";"Total";"Total";"2543";"1264";"1279"
"Santa Rita do Passa Quatro (SP)";"Total";"Total";"26478";"12813";"13665"
"Santa Rosa de Viterbo (SP)";"Total";"Total";"23862";"11781";"12081"
"Santa Salete (SP)";"Total";"Total";"1447";"743";"704"
"Santo Anastácio (SP)";"Total";"Total";"20475";"9982";"10493"
"Santo André (SP)";"Total";"Total";"676407";"324458";"351949"
"Santo Antônio da Alegria (SP)";"Total";"Total";"6304";"3260";"3044"
"Santo Antônio de Posse (SP)";"Total";"Total";"20650";"10412";"10238"
"Santo Antônio do Aracanguá (SP)";"Total";"Total";"7626";"3879";"3747"
"Santo Antônio do Jardim (SP)";"Total";"Total";"5943";"3045";"2898"
"Santo Antônio do Pinhal (SP)";"Total";"Total";"6486";"3269";"3217"
"Santo Expedito (SP)";"Total";"Total";"2803";"1403";"1400"
"Santópolis do Aguapeí (SP)";"Total";"Total";"4277";"2167";"2110"
"Santos (SP)";"Total";"Total";"419400";"191912";"227488"
"São Bento do Sapucaí (SP)";"Total";"Total";"10468";"5271";"5197"
"São Bernardo do Campo (SP)";"Total";"Total";"765463";"369626";"395837"
"São Caetano do Sul (SP)";"Total";"Total";"149263";"68853";"80410"
"São Carlos (SP)";"Total";"Total";"221950";"108914";"113036"
"São Francisco (SP)";"Total";"Total";"2793";"1400";"1393"
"São João da Boa Vista (SP)";"Total";"Total";"83639";"40546";"43093"
"São João das Duas Pontes (SP)";"Total";"Total";"2566";"1290";"1276"
"São João de Iracema (SP)";"Total";"Total";"1780";"898";"882"
"São João do Pau d'Alho (SP)";"Total";"Total";"2103";"1057";"1046"
"São Joaquim da Barra (SP)";"Total";"Total";"46512";"22792";"23720"
"São José da Bela Vista (SP)";"Total";"Total";"8406";"4312";"4094"
"São José do Barreiro (SP)";"Total";"Total";"4077";"2047";"2030"
"São José do Rio Pardo (SP)";"Total";"Total";"51900";"25547";"26353"
"São José do Rio Preto (SP)";"Total";"Total";"408258";"196016";"212242"
"São José dos Campos (SP)";"Total";"Total";"629921";"308624";"321297"
"São Lourenço da Serra (SP)";"Total";"Total";"13973";"7087";"6886"
"São Luiz do Paraitinga (SP)";"Total";"Total";"10397";"5318";"5079"
"São Manuel (SP)";"Total";"Total";"38342";"18766";"19576"
"São Miguel Arcanjo (SP)";"Total";"Total";"31450";"15995";"15455"
"São Paulo (SP)";"Total";"Total";"11253503";"5328632";"5924871"
"São Pedro (SP)";"Total";"Total";"31662";"15423";"16239"
"São Pedro do Turvo (SP)";"Total";"Total";"7198";"3670";"3528"
"São Roque (SP)";"Total";"Total";"78821";"38762";"40059"
"São Sebastião (SP)";"Total";"Total";"73942";"36886";"37056"
"São Sebastião da Grama (SP)";"Total";"Total";"12099";"6166";"5933"
"São Simão (SP)";"Total";"Total";"14346";"7061";"7285"
"São Vicente (SP)";"Total";"Total";"332445";"159664";"172781"
"Sarapuí (SP)";"Total";"Total";"9027";"4594";"4433"
"Sarutaiá (SP)";"Total";"Total";"3622";"1819";"1803"
"Sebastianópolis do Sul (SP)";"Total";"Total";"3031";"1525";"1506"
"Serra Azul (SP)";"Total";"Total";"11256";"6873";"4383"
"Serrana (SP)";"Total";"Total";"38878";"19486";"19392"
"Serra Negra (SP)";"Total";"Total";"26387";"12866";"13521"
"Sertãozinho (SP)";"Total";"Total";"110074";"54701";"55373"
"Sete Barras (SP)";"Total";"Total";"13005";"6681";"6324"
"Severínia (SP)";"Total";"Total";"15501";"8045";"7456"
"Silveiras (SP)";"Total";"Total";"5792";"2936";"2856"
"Socorro (SP)";"Total";"Total";"36686";"18205";"18481"
"Sorocaba (SP)";"Total";"Total";"586625";"287014";"299611"
"Sud Mennucci (SP)";"Total";"Total";"7435";"3742";"3693"
"Sumaré (SP)";"Total";"Total";"241311";"119863";"121448"
"Suzano (SP)";"Total";"Total";"262480";"128694";"133786"
"Suzanápolis (SP)";"Total";"Total";"3383";"1748";"1635"
"Tabapuã (SP)";"Total";"Total";"11363";"5745";"5618"
"Tabatinga (SP)";"Total";"Total";"14686";"7565";"7121"
"Taboão da Serra (SP)";"Total";"Total";"244528";"116895";"127633"
"Taciba (SP)";"Total";"Total";"5714";"2861";"2853"
"Taguaí (SP)";"Total";"Total";"10828";"5385";"5443"
"Taiaçu (SP)";"Total";"Total";"5894";"2972";"2922"
"Taiúva (SP)";"Total";"Total";"5447";"2696";"2751"
"Tambaú (SP)";"Total";"Total";"22406";"11173";"11233"
"Tanabi (SP)";"Total";"Total";"24055";"12042";"12013"
"Tapiraí (SP)";"Total";"Total";"8012";"4043";"3969"
"Tapiratiba (SP)";"Total";"Total";"12737";"6331";"6406"
"Taquaral (SP)";"Total";"Total";"2726";"1373";"1353"
"Taquaritinga (SP)";"Total";"Total";"53988";"26662";"27326"
"Taquarituba (SP)";"Total";"Total";"22291";"11092";"11199"
"Taquarivaí (SP)";"Total";"Total";"5151";"2578";"2573"
"Tarabai (SP)";"Total";"Total";"6607";"3293";"3314"
"Tarumã (SP)";"Total";"Total";"12885";"6583";"6302"
"Tatuí (SP)";"Total";"Total";"107326";"53034";"54292"
"Taubaté (SP)";"Total";"Total";"278686";"136752";"141934"
"Tejupá (SP)";"Total";"Total";"4809";"2467";"2342"
"Teodoro Sampaio (SP)";"Total";"Total";"21386";"10665";"10721"
"Terra Roxa (SP)";"Total";"Total";"8505";"4306";"4199"
"Tietê (SP)";"Total";"Total";"36835";"18249";"18586"
"Timburi (SP)";"Total";"Total";"2646";"1364";"1282"
"Torre de Pedra (SP)";"Total";"Total";"2254";"1188";"1066"
"Torrinha (SP)";"Total";"Total";"9330";"4707";"4623"
"Trabiju (SP)";"Total";"Total";"1544";"770";"774"
"Tremembé (SP)";"Total";"Total";"40984";"21663";"19321"
"Três Fronteiras (SP)";"Total";"Total";"5427";"2718";"2709"
"Tuiuti (SP)";"Total";"Total";"5930";"3022";"2908"
"Tupã (SP)";"Total";"Total";"63476";"30734";"32742"
"Tupi Paulista (SP)";"Total";"Total";"14269";"7580";"6689"
"Turiúba (SP)";"Total";"Total";"1930";"997";"933"
"Turmalina (SP)";"Total";"Total";"1978";"982";"996"
"Ubarana (SP)";"Total";"Total";"5289";"2715";"2574"
"Ubatuba (SP)";"Total";"Total";"78801";"39176";"39625"
"Ubirajara (SP)";"Total";"Total";"4427";"2284";"2143"
"Uchoa (SP)";"Total";"Total";"9471";"4707";"4764"
"União Paulista (SP)";"Total";"Total";"1599";"829";"770"
"Urânia (SP)";"Total";"Total";"8836";"4395";"4441"
"Uru (SP)";"Total";"Total";"1251";"641";"610"
"Urupês (SP)";"Total";"Total";"12714";"6321";"6393"
"Valentim Gentil (SP)";"Total";"Total";"11036";"5548";"5488"
"Valinhos (SP)";"Total";"Total";"106793";"52676";"54117"
"Valparaíso (SP)";"Total";"Total";"22576";"12413";"10163"
"Vargem (SP)";"Total";"Total";"8801";"4519";"4282"
"Vargem Grande do Sul (SP)";"Total";"Total";"39266";"19488";"19778"
"Vargem Grande Paulista (SP)";"Total";"Total";"42997";"21342";"21655"
"Várzea Paulista (SP)";"Total";"Total";"107089";"53415";"53674"
"Vera Cruz (SP)";"Total";"Total";"10769";"5298";"5471"
"Vinhedo (SP)";"Total";"Total";"63611";"31483";"32128"
"Viradouro (SP)";"Total";"Total";"17297";"8714";"8583"
"Vista Alegre do Alto (SP)";"Total";"Total";"6886";"3544";"3342"
"Vitória Brasil (SP)";"Total";"Total";"1737";"891";"846"
"Votorantim (SP)";"Total";"Total";"108809";"54013";"54796"
"Votuporanga (SP)";"Total";"Total";"84692";"41315";"43377"
"Zacarias (SP)";"Total";"Total";"2335";"1173";"1162"
"Chavantes (SP)";"Total";"Total";"12114";"6028";"6086"
"Estiva Gerbi (SP)";"Total";"Total";"10044";"5074";"4970"
"Abatiá (PR)";"Total";"Total";"7764";"3916";"3848"
"Adrianópolis (PR)";"Total";"Total";"6376";"3298";"3078"
"Agudos do Sul (PR)";"Total";"Total";"8270";"4306";"3964"
"Almirante Tamandaré (PR)";"Total";"Total";"103204";"51136";"52068"
"Altamira do Paraná (PR)";"Total";"Total";"4306";"2202";"2104"
"Altônia (PR)";"Total";"Total";"20516";"10157";"10359"
"Alto Paraná (PR)";"Total";"Total";"13663";"6842";"6821"
"Alto Piquiri (PR)";"Total";"Total";"10179";"5129";"5050"
"Alvorada do Sul (PR)";"Total";"Total";"10283";"5205";"5078"
"Amaporã (PR)";"Total";"Total";"5443";"2757";"2686"
"Ampére (PR)";"Total";"Total";"17308";"8586";"8722"
"Anahy (PR)";"Total";"Total";"2874";"1439";"1435"
"Andirá (PR)";"Total";"Total";"20610";"10041";"10569"
"Ângulo (PR)";"Total";"Total";"2859";"1457";"1402"
"Antonina (PR)";"Total";"Total";"18891";"9349";"9542"
"Antônio Olinto (PR)";"Total";"Total";"7351";"3857";"3494"
"Apucarana (PR)";"Total";"Total";"120919";"58682";"62237"
"Arapongas (PR)";"Total";"Total";"104150";"51039";"53111"
"Arapoti (PR)";"Total";"Total";"25855";"12949";"12906"
"Arapuã (PR)";"Total";"Total";"3561";"1764";"1797"
"Araruna (PR)";"Total";"Total";"13419";"6824";"6595"
"Araucária (PR)";"Total";"Total";"119123";"59606";"59517"
"Ariranha do Ivaí (PR)";"Total";"Total";"2453";"1229";"1224"
"Assaí (PR)";"Total";"Total";"16354";"8012";"8342"
"Assis Chateaubriand (PR)";"Total";"Total";"33025";"16178";"16847"
"Astorga (PR)";"Total";"Total";"24698";"12142";"12556"
"Atalaia (PR)";"Total";"Total";"3913";"1970";"1943"
"Balsa Nova (PR)";"Total";"Total";"11300";"5721";"5579"
"Bandeirantes (PR)";"Total";"Total";"32184";"15551";"16633"
"Barbosa Ferraz (PR)";"Total";"Total";"12656";"6351";"6305"
"Barracão (PR)";"Total";"Total";"9735";"4794";"4941"
"Barra do Jacaré (PR)";"Total";"Total";"2727";"1385";"1342"
"Bela Vista da Caroba (PR)";"Total";"Total";"3945";"2018";"1927"
"Bela Vista do Paraíso (PR)";"Total";"Total";"15079";"7317";"7762"
"Bituruna (PR)";"Total";"Total";"15880";"8150";"7730"
"Boa Esperança (PR)";"Total";"Total";"4568";"2280";"2288"
"Boa Esperança do Iguaçu (PR)";"Total";"Total";"2764";"1402";"1362"
"Boa Ventura de São Roque (PR)";"Total";"Total";"6554";"3346";"3208"
"Boa Vista da Aparecida (PR)";"Total";"Total";"7911";"3994";"3917"
"Bocaiúva do Sul (PR)";"Total";"Total";"10987";"5552";"5435"
"Bom Jesus do Sul (PR)";"Total";"Total";"3796";"1969";"1827"
"Bom Sucesso (PR)";"Total";"Total";"6561";"3227";"3334"
"Bom Sucesso do Sul (PR)";"Total";"Total";"3293";"1638";"1655"
"Borrazópolis (PR)";"Total";"Total";"7878";"3933";"3945"
"Braganey (PR)";"Total";"Total";"5735";"2939";"2796"
"Brasilândia do Sul (PR)";"Total";"Total";"3209";"1603";"1606"
"Cafeara (PR)";"Total";"Total";"2695";"1376";"1319"
"Cafelândia (PR)";"Total";"Total";"14662";"7345";"7317"
"Cafezal do Sul (PR)";"Total";"Total";"4290";"2170";"2120"
"Califórnia (PR)";"Total";"Total";"8069";"4051";"4018"
"Cambará (PR)";"Total";"Total";"23886";"11648";"12238"
"Cambé (PR)";"Total";"Total";"96733";"47299";"49434"
"Cambira (PR)";"Total";"Total";"7236";"3679";"3557"
"Campina da Lagoa (PR)";"Total";"Total";"15394";"7647";"7747"
"Campina do Simão (PR)";"Total";"Total";"4076";"2136";"1940"
"Campina Grande do Sul (PR)";"Total";"Total";"38769";"19229";"19540"
"Campo Bonito (PR)";"Total";"Total";"4407";"2215";"2192"
"Campo do Tenente (PR)";"Total";"Total";"7125";"3676";"3449"
"Campo Largo (PR)";"Total";"Total";"112377";"55660";"56717"
"Campo Magro (PR)";"Total";"Total";"24843";"12507";"12336"
"Campo Mourão (PR)";"Total";"Total";"87194";"42013";"45181"
"Cândido de Abreu (PR)";"Total";"Total";"16655";"8543";"8112"
"Candói (PR)";"Total";"Total";"14983";"7551";"7432"
"Cantagalo (PR)";"Total";"Total";"12952";"6562";"6390"
"Capanema (PR)";"Total";"Total";"18526";"9160";"9366"
"Capitão Leônidas Marques (PR)";"Total";"Total";"14970";"7474";"7496"
"Carambeí (PR)";"Total";"Total";"19163";"9702";"9461"
"Carlópolis (PR)";"Total";"Total";"13706";"6925";"6781"
"Cascavel (PR)";"Total";"Total";"286205";"139771";"146434"
"Castro (PR)";"Total";"Total";"67084";"33390";"33694"
"Catanduvas (PR)";"Total";"Total";"10202";"5192";"5010"
"Centenário do Sul (PR)";"Total";"Total";"11190";"5562";"5628"
"Cerro Azul (PR)";"Total";"Total";"16938";"8718";"8220"
"Céu Azul (PR)";"Total";"Total";"11032";"5413";"5619"
"Chopinzinho (PR)";"Total";"Total";"19679";"9775";"9904"
"Cianorte (PR)";"Total";"Total";"69958";"34041";"35917"
"Cidade Gaúcha (PR)";"Total";"Total";"11062";"5531";"5531"
"Clevelândia (PR)";"Total";"Total";"17240";"8439";"8801"
"Colombo (PR)";"Total";"Total";"212967";"105010";"107957"
"Colorado (PR)";"Total";"Total";"22345";"11042";"11303"
"Congonhinhas (PR)";"Total";"Total";"8279";"4237";"4042"
"Conselheiro Mairinck (PR)";"Total";"Total";"3636";"1839";"1797"
"Contenda (PR)";"Total";"Total";"15891";"8095";"7796"
"Corbélia (PR)";"Total";"Total";"16312";"7973";"8339"
"Cornélio Procópio (PR)";"Total";"Total";"46928";"22697";"24231"
"Coronel Domingos Soares (PR)";"Total";"Total";"7238";"3791";"3447"
"Coronel Vivida (PR)";"Total";"Total";"21749";"10621";"11128"
"Corumbataí do Sul (PR)";"Total";"Total";"4002";"2030";"1972"
"Cruzeiro do Iguaçu (PR)";"Total";"Total";"4278";"2133";"2145"
"Cruzeiro do Oeste (PR)";"Total";"Total";"20416";"9988";"10428"
"Cruzeiro do Sul (PR)";"Total";"Total";"4563";"2310";"2253"
"Cruz Machado (PR)";"Total";"Total";"18040";"9322";"8718"
"Cruzmaltina (PR)";"Total";"Total";"3162";"1635";"1527"
"Curitiba (PR)";"Total";"Total";"1751907";"835115";"916792"
"Curiúva (PR)";"Total";"Total";"13923";"7107";"6816"
"Diamante do Norte (PR)";"Total";"Total";"5516";"2730";"2786"
"Diamante do Sul (PR)";"Total";"Total";"3510";"1796";"1714"
"Diamante D'Oeste (PR)";"Total";"Total";"5027";"2570";"2457"
"Dois Vizinhos (PR)";"Total";"Total";"36179";"17986";"18193"
"Douradina (PR)";"Total";"Total";"7445";"3770";"3675"
"Doutor Camargo (PR)";"Total";"Total";"5828";"2868";"2960"
"Enéas Marques (PR)";"Total";"Total";"6103";"3134";"2969"
"Engenheiro Beltrão (PR)";"Total";"Total";"13906";"6926";"6980"
"Esperança Nova (PR)";"Total";"Total";"1970";"981";"989"
"Entre Rios do Oeste (PR)";"Total";"Total";"3926";"1959";"1967"
"Espigão Alto do Iguaçu (PR)";"Total";"Total";"4677";"2386";"2291"
"Farol (PR)";"Total";"Total";"3472";"1723";"1749"
"Faxinal (PR)";"Total";"Total";"16314";"8025";"8289"
"Fazenda Rio Grande (PR)";"Total";"Total";"81675";"40574";"41101"
"Fênix (PR)";"Total";"Total";"4802";"2398";"2404"
"Fernandes Pinheiro (PR)";"Total";"Total";"5932";"3039";"2893"
"Figueira (PR)";"Total";"Total";"8293";"4103";"4190"
"Floraí (PR)";"Total";"Total";"5050";"2502";"2548"
"Flor da Serra do Sul (PR)";"Total";"Total";"4726";"2398";"2328"
"Floresta (PR)";"Total";"Total";"5931";"2953";"2978"
"Florestópolis (PR)";"Total";"Total";"11222";"5687";"5535"
"Flórida (PR)";"Total";"Total";"2543";"1289";"1254"
"Formosa do Oeste (PR)";"Total";"Total";"7541";"3784";"3757"
"Foz do Iguaçu (PR)";"Total";"Total";"256088";"124218";"131870"
"Francisco Alves (PR)";"Total";"Total";"6418";"3224";"3194"
"Francisco Beltrão (PR)";"Total";"Total";"78943";"38958";"39985"
"Foz do Jordão (PR)";"Total";"Total";"5420";"2685";"2735"
"General Carneiro (PR)";"Total";"Total";"13669";"6898";"6771"
"Godoy Moreira (PR)";"Total";"Total";"3337";"1701";"1636"
"Goioerê (PR)";"Total";"Total";"29018";"14006";"15012"
"Goioxim (PR)";"Total";"Total";"7503";"3924";"3579"
"Grandes Rios (PR)";"Total";"Total";"6625";"3385";"3240"
"Guaíra (PR)";"Total";"Total";"30704";"14932";"15772"
"Guairaçá (PR)";"Total";"Total";"6197";"3106";"3091"
"Guamiranga (PR)";"Total";"Total";"7900";"4008";"3892"
"Guapirama (PR)";"Total";"Total";"3891";"1934";"1957"
"Guaporema (PR)";"Total";"Total";"2219";"1135";"1084"
"Guaraci (PR)";"Total";"Total";"5227";"2574";"2653"
"Guaraniaçu (PR)";"Total";"Total";"14582";"7263";"7319"
"Guarapuava (PR)";"Total";"Total";"167328";"81797";"85531"
"Guaraqueçaba (PR)";"Total";"Total";"7871";"4176";"3695"
"Guaratuba (PR)";"Total";"Total";"32095";"15975";"16120"
"Honório Serpa (PR)";"Total";"Total";"5955";"3092";"2863"
"Ibaiti (PR)";"Total";"Total";"28751";"14473";"14278"
"Ibema (PR)";"Total";"Total";"6066";"3036";"3030"
"Ibiporã (PR)";"Total";"Total";"48198";"23437";"24761"
"Icaraíma (PR)";"Total";"Total";"8839";"4458";"4381"
"Iguaraçu (PR)";"Total";"Total";"3982";"2004";"1978"
"Iguatu (PR)";"Total";"Total";"2234";"1136";"1098"
"Imbaú (PR)";"Total";"Total";"11274";"5748";"5526"
"Imbituva (PR)";"Total";"Total";"28455";"14390";"14065"
"Inácio Martins (PR)";"Total";"Total";"10943";"5604";"5339"
"Inajá (PR)";"Total";"Total";"2988";"1528";"1460"
"Indianópolis (PR)";"Total";"Total";"4299";"2187";"2112"
"Ipiranga (PR)";"Total";"Total";"14150";"7328";"6822"
"Iporã (PR)";"Total";"Total";"14981";"7393";"7588"
"Iracema do Oeste (PR)";"Total";"Total";"2578";"1320";"1258"
"Irati (PR)";"Total";"Total";"56207";"27708";"28499"
"Iretama (PR)";"Total";"Total";"10622";"5433";"5189"
"Itaguajé (PR)";"Total";"Total";"4568";"2296";"2272"
"Itaipulândia (PR)";"Total";"Total";"9026";"4549";"4477"
"Itambaracá (PR)";"Total";"Total";"6759";"3390";"3369"
"Itambé (PR)";"Total";"Total";"5979";"2946";"3033"
"Itapejara d'Oeste (PR)";"Total";"Total";"10531";"5262";"5269"
"Itaperuçu (PR)";"Total";"Total";"23887";"11984";"11903"
"Itaúna do Sul (PR)";"Total";"Total";"3583";"1822";"1761"
"Ivaí (PR)";"Total";"Total";"12815";"6684";"6131"
"Ivaiporã (PR)";"Total";"Total";"31816";"15420";"16396"
"Ivaté (PR)";"Total";"Total";"7514";"3808";"3706"
"Ivatuba (PR)";"Total";"Total";"3010";"1436";"1574"
"Jaboti (PR)";"Total";"Total";"4902";"2488";"2414"
"Jacarezinho (PR)";"Total";"Total";"39121";"19136";"19985"
"Jaguapitã (PR)";"Total";"Total";"12225";"6109";"6116"
"Jaguariaíva (PR)";"Total";"Total";"32606";"16092";"16514"
"Jandaia do Sul (PR)";"Total";"Total";"20269";"9880";"10389"
"Janiópolis (PR)";"Total";"Total";"6532";"3273";"3259"
"Japira (PR)";"Total";"Total";"4903";"2539";"2364"
"Japurá (PR)";"Total";"Total";"8549";"4324";"4225"
"Jardim Alegre (PR)";"Total";"Total";"12324";"6269";"6055"
"Jardim Olinda (PR)";"Total";"Total";"1409";"699";"710"
"Jataizinho (PR)";"Total";"Total";"11875";"5873";"6002"
"Jesuítas (PR)";"Total";"Total";"9001";"4469";"4532"
"Joaquim Távora (PR)";"Total";"Total";"10736";"5321";"5415"
"Jundiaí do Sul (PR)";"Total";"Total";"3433";"1738";"1695"
"Juranda (PR)";"Total";"Total";"7641";"3815";"3826"
"Jussara (PR)";"Total";"Total";"6610";"3260";"3350"
"Kaloré (PR)";"Total";"Total";"4506";"2288";"2218"
"Lapa (PR)";"Total";"Total";"44932";"22646";"22286"
"Laranjal (PR)";"Total";"Total";"6360";"3236";"3124"
"Laranjeiras do Sul (PR)";"Total";"Total";"30777";"14992";"15785"
"Leópolis (PR)";"Total";"Total";"4145";"2054";"2091"
"Lidianópolis (PR)";"Total";"Total";"3973";"1962";"2011"
"Lindoeste (PR)";"Total";"Total";"5361";"2792";"2569"
"Loanda (PR)";"Total";"Total";"21201";"10447";"10754"
"Lobato (PR)";"Total";"Total";"4401";"2234";"2167"
"Londrina (PR)";"Total";"Total";"506701";"243059";"263642"
"Luiziana (PR)";"Total";"Total";"7315";"3736";"3579"
"Lunardelli (PR)";"Total";"Total";"5160";"2559";"2601"
"Lupionópolis (PR)";"Total";"Total";"4592";"2261";"2331"
"Mallet (PR)";"Total";"Total";"12973";"6699";"6274"
"Mamborê (PR)";"Total";"Total";"13961";"6947";"7014"
"Mandaguaçu (PR)";"Total";"Total";"19781";"9853";"9928"
"Mandaguari (PR)";"Total";"Total";"32658";"16035";"16623"
"Mandirituba (PR)";"Total";"Total";"22220";"11315";"10905"
"Manfrinópolis (PR)";"Total";"Total";"3127";"1680";"1447"
"Mangueirinha (PR)";"Total";"Total";"17048";"8439";"8609"
"Manoel Ribas (PR)";"Total";"Total";"13169";"6527";"6642"
"Marechal Cândido Rondon (PR)";"Total";"Total";"46819";"22833";"23986"
"Maria Helena (PR)";"Total";"Total";"5956";"2993";"2963"
"Marialva (PR)";"Total";"Total";"31959";"15795";"16164"
"Marilândia do Sul (PR)";"Total";"Total";"8863";"4500";"4363"
"Marilena (PR)";"Total";"Total";"6858";"3533";"3325"
"Mariluz (PR)";"Total";"Total";"10224";"5113";"5111"
"Maringá (PR)";"Total";"Total";"357077";"171724";"185353"
"Mariópolis (PR)";"Total";"Total";"6268";"3116";"3152"
"Maripá (PR)";"Total";"Total";"5684";"2840";"2844"
"Marmeleiro (PR)";"Total";"Total";"13900";"6909";"6991"
"Marquinho (PR)";"Total";"Total";"4981";"2612";"2369"
"Marumbi (PR)";"Total";"Total";"4603";"2288";"2315"
"Matelândia (PR)";"Total";"Total";"16078";"7968";"8110"
"Matinhos (PR)";"Total";"Total";"29428";"14335";"15093"
"Mato Rico (PR)";"Total";"Total";"3818";"2029";"1789"
"Mauá da Serra (PR)";"Total";"Total";"8555";"4361";"4194"
"Medianeira (PR)";"Total";"Total";"41817";"20567";"21250"
"Mercedes (PR)";"Total";"Total";"5046";"2524";"2522"
"Mirador (PR)";"Total";"Total";"2327";"1180";"1147"
"Miraselva (PR)";"Total";"Total";"1862";"923";"939"
"Missal (PR)";"Total";"Total";"10474";"5269";"5205"
"Moreira Sales (PR)";"Total";"Total";"12606";"6315";"6291"
"Morretes (PR)";"Total";"Total";"15718";"7950";"7768"
"Munhoz de Melo (PR)";"Total";"Total";"3672";"1836";"1836"
"Nossa Senhora das Graças (PR)";"Total";"Total";"3836";"1952";"1884"
"Nova Aliança do Ivaí (PR)";"Total";"Total";"1431";"718";"713"
"Nova América da Colina (PR)";"Total";"Total";"3478";"1769";"1709"
"Nova Aurora (PR)";"Total";"Total";"11866";"5828";"6038"
"Nova Cantu (PR)";"Total";"Total";"7425";"3757";"3668"
"Nova Esperança (PR)";"Total";"Total";"26615";"13019";"13596"
"Nova Esperança do Sudoeste (PR)";"Total";"Total";"5098";"2657";"2441"
"Nova Fátima (PR)";"Total";"Total";"8147";"4034";"4113"
"Nova Laranjeiras (PR)";"Total";"Total";"11241";"5691";"5550"
"Nova Londrina (PR)";"Total";"Total";"13067";"6425";"6642"
"Nova Olímpia (PR)";"Total";"Total";"5503";"2691";"2812"
"Nova Santa Bárbara (PR)";"Total";"Total";"3908";"1896";"2012"
"Nova Santa Rosa (PR)";"Total";"Total";"7626";"3791";"3835"
"Nova Prata do Iguaçu (PR)";"Total";"Total";"10377";"5225";"5152"
"Nova Tebas (PR)";"Total";"Total";"7398";"3814";"3584"
"Novo Itacolomi (PR)";"Total";"Total";"2827";"1485";"1342"
"Ortigueira (PR)";"Total";"Total";"23380";"12078";"11302"
"Ourizona (PR)";"Total";"Total";"3380";"1705";"1675"
"Ouro Verde do Oeste (PR)";"Total";"Total";"5692";"2867";"2825"
"Paiçandu (PR)";"Total";"Total";"35936";"17822";"18114"
"Palmas (PR)";"Total";"Total";"42888";"21183";"21705"
"Palmeira (PR)";"Total";"Total";"32123";"16046";"16077"
"Palmital (PR)";"Total";"Total";"14865";"7513";"7352"
"Palotina (PR)";"Total";"Total";"28683";"13997";"14686"
"Paraíso do Norte (PR)";"Total";"Total";"11772";"5851";"5921"
"Paranacity (PR)";"Total";"Total";"10250";"5115";"5135"
"Paranaguá (PR)";"Total";"Total";"140469";"69306";"71163"
"Paranapoema (PR)";"Total";"Total";"2791";"1383";"1408"
"Paranavaí (PR)";"Total";"Total";"81590";"39282";"42308"
"Pato Bragado (PR)";"Total";"Total";"4822";"2368";"2454"
"Pato Branco (PR)";"Total";"Total";"72370";"34984";"37386"
"Paula Freitas (PR)";"Total";"Total";"5434";"2802";"2632"
"Paulo Frontin (PR)";"Total";"Total";"6913";"3633";"3280"
"Peabiru (PR)";"Total";"Total";"13624";"6731";"6893"
"Perobal (PR)";"Total";"Total";"5653";"2825";"2828"
"Pérola (PR)";"Total";"Total";"10208";"5004";"5204"
"Pérola d'Oeste (PR)";"Total";"Total";"6761";"3401";"3360"
"Piên (PR)";"Total";"Total";"11236";"5759";"5477"
"Pinhais (PR)";"Total";"Total";"117008";"56809";"60199"
"Pinhalão (PR)";"Total";"Total";"6215";"3165";"3050"
"Pinhal de São Bento (PR)";"Total";"Total";"2625";"1369";"1256"
"Pinhão (PR)";"Total";"Total";"30208";"15181";"15027"
"Piraí do Sul (PR)";"Total";"Total";"23424";"11620";"11804"
"Piraquara (PR)";"Total";"Total";"93207";"48194";"45013"
"Pitanga (PR)";"Total";"Total";"32638";"16250";"16388"
"Pitangueiras (PR)";"Total";"Total";"2814";"1441";"1373"
"Planaltina do Paraná (PR)";"Total";"Total";"4095";"2070";"2025"
"Planalto (PR)";"Total";"Total";"13654";"6849";"6805"
"Ponta Grossa (PR)";"Total";"Total";"311611";"151362";"160249"
"Pontal do Paraná (PR)";"Total";"Total";"20920";"10357";"10563"
"Porecatu (PR)";"Total";"Total";"14189";"7036";"7153"
"Porto Amazonas (PR)";"Total";"Total";"4514";"2256";"2258"
"Porto Barreiro (PR)";"Total";"Total";"3663";"1915";"1748"
"Porto Rico (PR)";"Total";"Total";"2530";"1284";"1246"
"Porto Vitória (PR)";"Total";"Total";"4020";"2061";"1959"
"Prado Ferreira (PR)";"Total";"Total";"3434";"1740";"1694"
"Pranchita (PR)";"Total";"Total";"5628";"2816";"2812"
"Presidente Castelo Branco (PR)";"Total";"Total";"4784";"2455";"2329"
"Primeiro de Maio (PR)";"Total";"Total";"10832";"5401";"5431"
"Prudentópolis (PR)";"Total";"Total";"48792";"24891";"23901"
"Quarto Centenário (PR)";"Total";"Total";"4856";"2391";"2465"
"Quatiguá (PR)";"Total";"Total";"7045";"3453";"3592"
"Quatro Barras (PR)";"Total";"Total";"19851";"9955";"9896"
"Quatro Pontes (PR)";"Total";"Total";"3803";"1850";"1953"
"Quedas do Iguaçu (PR)";"Total";"Total";"30605";"15397";"15208"
"Querência do Norte (PR)";"Total";"Total";"11729";"5937";"5792"
"Quinta do Sol (PR)";"Total";"Total";"5088";"2545";"2543"
"Quitandinha (PR)";"Total";"Total";"17089";"8837";"8252"
"Ramilândia (PR)";"Total";"Total";"4134";"2124";"2010"
"Rancho Alegre (PR)";"Total";"Total";"3955";"1953";"2002"
"Rancho Alegre D'Oeste (PR)";"Total";"Total";"2847";"1414";"1433"
"Realeza (PR)";"Total";"Total";"16338";"8004";"8334"
"Rebouças (PR)";"Total";"Total";"14176";"7201";"6975"
"Renascença (PR)";"Total";"Total";"6812";"3427";"3385"
"Reserva (PR)";"Total";"Total";"25172";"12926";"12246"
"Reserva do Iguaçu (PR)";"Total";"Total";"7307";"3747";"3560"
"Ribeirão Claro (PR)";"Total";"Total";"10678";"5272";"5406"
"Ribeirão do Pinhal (PR)";"Total";"Total";"13524";"6731";"6793"
"Rio Azul (PR)";"Total";"Total";"14093";"7340";"6753"
"Rio Bom (PR)";"Total";"Total";"3334";"1742";"1592"
"Rio Bonito do Iguaçu (PR)";"Total";"Total";"13661";"7059";"6602"
"Rio Branco do Ivaí (PR)";"Total";"Total";"3898";"1962";"1936"
"Rio Branco do Sul (PR)";"Total";"Total";"30650";"15546";"15104"
"Rio Negro (PR)";"Total";"Total";"31274";"15570";"15704"
"Rolândia (PR)";"Total";"Total";"57862";"28459";"29403"
"Roncador (PR)";"Total";"Total";"11537";"5823";"5714"
"Rondon (PR)";"Total";"Total";"8996";"4564";"4432"
"Rosário do Ivaí (PR)";"Total";"Total";"5588";"2831";"2757"
"Sabáudia (PR)";"Total";"Total";"6096";"3051";"3045"
"Salgado Filho (PR)";"Total";"Total";"4403";"2248";"2155"
"Salto do Itararé (PR)";"Total";"Total";"5178";"2614";"2564"
"Salto do Lontra (PR)";"Total";"Total";"13689";"6941";"6748"
"Santa Amélia (PR)";"Total";"Total";"3803";"1906";"1897"
"Santa Cecília do Pavão (PR)";"Total";"Total";"3646";"1804";"1842"
"Santa Cruz de Monte Castelo (PR)";"Total";"Total";"8092";"4051";"4041"
"Santa Fé (PR)";"Total";"Total";"10432";"5118";"5314"
"Santa Helena (PR)";"Total";"Total";"23413";"11506";"11907"
"Santa Inês (PR)";"Total";"Total";"1818";"927";"891"
"Santa Isabel do Ivaí (PR)";"Total";"Total";"8760";"4387";"4373"
"Santa Izabel do Oeste (PR)";"Total";"Total";"13132";"6628";"6504"
"Santa Lúcia (PR)";"Total";"Total";"3925";"1959";"1966"
"Santa Maria do Oeste (PR)";"Total";"Total";"11500";"5913";"5587"
"Santa Mariana (PR)";"Total";"Total";"12435";"6171";"6264"
"Santa Mônica (PR)";"Total";"Total";"3571";"1843";"1728"
"Santana do Itararé (PR)";"Total";"Total";"5249";"2643";"2606"
"Santa Tereza do Oeste (PR)";"Total";"Total";"10332";"5248";"5084"
"Santa Terezinha de Itaipu (PR)";"Total";"Total";"20841";"10197";"10644"
"Santo Antônio da Platina (PR)";"Total";"Total";"42707";"21003";"21704"
"Santo Antônio do Caiuá (PR)";"Total";"Total";"2727";"1346";"1381"
"Santo Antônio do Paraíso (PR)";"Total";"Total";"2408";"1200";"1208"
"Santo Antônio do Sudoeste (PR)";"Total";"Total";"18893";"9265";"9628"
"Santo Inácio (PR)";"Total";"Total";"5269";"2663";"2606"
"São Carlos do Ivaí (PR)";"Total";"Total";"6354";"3254";"3100"
"São Jerônimo da Serra (PR)";"Total";"Total";"11337";"5846";"5491"
"São João (PR)";"Total";"Total";"10599";"5240";"5359"
"São João do Caiuá (PR)";"Total";"Total";"5911";"2925";"2986"
"São João do Ivaí (PR)";"Total";"Total";"11525";"5678";"5847"
"São João do Triunfo (PR)";"Total";"Total";"13704";"7208";"6496"
"São Jorge d'Oeste (PR)";"Total";"Total";"9085";"4546";"4539"
"São Jorge do Ivaí (PR)";"Total";"Total";"5517";"2724";"2793"
"São Jorge do Patrocínio (PR)";"Total";"Total";"6041";"3068";"2973"
"São José da Boa Vista (PR)";"Total";"Total";"6511";"3363";"3148"
"São José das Palmeiras (PR)";"Total";"Total";"3830";"1926";"1904"
"São José dos Pinhais (PR)";"Total";"Total";"264210";"130597";"133613"
"São Manoel do Paraná (PR)";"Total";"Total";"2098";"1054";"1044"
"São Mateus do Sul (PR)";"Total";"Total";"41257";"20781";"20476"
"São Miguel do Iguaçu (PR)";"Total";"Total";"25769";"12857";"12912"
"São Pedro do Iguaçu (PR)";"Total";"Total";"6491";"3292";"3199"
"São Pedro do Ivaí (PR)";"Total";"Total";"10167";"5115";"5052"
"São Pedro do Paraná (PR)";"Total";"Total";"2491";"1261";"1230"
"São Sebastião da Amoreira (PR)";"Total";"Total";"8626";"4256";"4370"
"São Tomé (PR)";"Total";"Total";"5349";"2696";"2653"
"Sapopema (PR)";"Total";"Total";"6736";"3507";"3229"
"Sarandi (PR)";"Total";"Total";"82847";"40830";"42017"
"Saudade do Iguaçu (PR)";"Total";"Total";"5028";"2537";"2491"
"Sengés (PR)";"Total";"Total";"18414";"9463";"8951"
"Serranópolis do Iguaçu (PR)";"Total";"Total";"4568";"2229";"2339"
"Sertaneja (PR)";"Total";"Total";"5817";"2896";"2921"
"Sertanópolis (PR)";"Total";"Total";"15638";"7748";"7890"
"Siqueira Campos (PR)";"Total";"Total";"18454";"9206";"9248"
"Sulina (PR)";"Total";"Total";"3394";"1713";"1681"
"Tamarana (PR)";"Total";"Total";"12262";"6276";"5986"
"Tamboara (PR)";"Total";"Total";"4664";"2309";"2355"
"Tapejara (PR)";"Total";"Total";"14598";"7305";"7293"
"Tapira (PR)";"Total";"Total";"5836";"2918";"2918"
"Teixeira Soares (PR)";"Total";"Total";"10283";"5332";"4951"
"Telêmaco Borba (PR)";"Total";"Total";"69872";"34386";"35486"
"Terra Boa (PR)";"Total";"Total";"15776";"7822";"7954"
"Terra Rica (PR)";"Total";"Total";"15221";"7609";"7612"
"Terra Roxa (PR)";"Total";"Total";"16759";"8295";"8464"
"Tibagi (PR)";"Total";"Total";"19344";"9804";"9540"
"Tijucas do Sul (PR)";"Total";"Total";"14537";"7546";"6991"
"Toledo (PR)";"Total";"Total";"119313";"58337";"60976"
"Tomazina (PR)";"Total";"Total";"8791";"4530";"4261"
"Três Barras do Paraná (PR)";"Total";"Total";"11824";"5994";"5830"
"Tunas do Paraná (PR)";"Total";"Total";"6256";"3271";"2985"
"Tuneiras do Oeste (PR)";"Total";"Total";"8695";"4441";"4254"
"Tupãssi (PR)";"Total";"Total";"7997";"4051";"3946"
"Turvo (PR)";"Total";"Total";"13811";"6980";"6831"
"Ubiratã (PR)";"Total";"Total";"21558";"10504";"11054"
"Umuarama (PR)";"Total";"Total";"100676";"48788";"51888"
"União da Vitória (PR)";"Total";"Total";"52735";"25818";"26917"
"Uniflor (PR)";"Total";"Total";"2466";"1232";"1234"
"Uraí (PR)";"Total";"Total";"11472";"5681";"5791"
"Wenceslau Braz (PR)";"Total";"Total";"19298";"9511";"9787"
"Ventania (PR)";"Total";"Total";"9957";"5144";"4813"
"Vera Cruz do Oeste (PR)";"Total";"Total";"8973";"4411";"4562"
"Verê (PR)";"Total";"Total";"7878";"3938";"3940"
"Alto Paraíso (PR)";"Total";"Total";"3206";"1619";"1587"
"Doutor Ulysses (PR)";"Total";"Total";"5727";"2980";"2747"
"Virmond (PR)";"Total";"Total";"3950";"1999";"1951"
"Vitorino (PR)";"Total";"Total";"6513";"3230";"3283"
"Xambrê (PR)";"Total";"Total";"6012";"2998";"3014"
"Abdon Batista (SC)";"Total";"Total";"2653";"1382";"1271"
"Abelardo Luz (SC)";"Total";"Total";"17100";"8628";"8472"
"Agrolândia (SC)";"Total";"Total";"9323";"4699";"4624"
"Agronômica (SC)";"Total";"Total";"4904";"2497";"2407"
"Água Doce (SC)";"Total";"Total";"6961";"3554";"3407"
"Águas de Chapecó (SC)";"Total";"Total";"6110";"3124";"2986"
"Águas Frias (SC)";"Total";"Total";"2424";"1279";"1145"
"Águas Mornas (SC)";"Total";"Total";"5548";"2810";"2738"
"Alfredo Wagner (SC)";"Total";"Total";"9410";"4784";"4626"
"Alto Bela Vista (SC)";"Total";"Total";"2005";"1005";"1000"
"Anchieta (SC)";"Total";"Total";"6380";"3231";"3149"
"Angelina (SC)";"Total";"Total";"5250";"2765";"2485"
"Anita Garibaldi (SC)";"Total";"Total";"8623";"4340";"4283"
"Anitápolis (SC)";"Total";"Total";"3214";"1675";"1539"
"Antônio Carlos (SC)";"Total";"Total";"7458";"3757";"3701"
"Apiúna (SC)";"Total";"Total";"9600";"4866";"4734"
"Arabutã (SC)";"Total";"Total";"4193";"2133";"2060"
"Araquari (SC)";"Total";"Total";"24810";"12648";"12162"
"Araranguá (SC)";"Total";"Total";"61310";"30138";"31172"
"Armazém (SC)";"Total";"Total";"7753";"3924";"3829"
"Arroio Trinta (SC)";"Total";"Total";"3502";"1747";"1755"
"Arvoredo (SC)";"Total";"Total";"2260";"1229";"1031"
"Ascurra (SC)";"Total";"Total";"7412";"3680";"3732"
"Atalanta (SC)";"Total";"Total";"3300";"1661";"1639"
"Aurora (SC)";"Total";"Total";"5549";"2824";"2725"
"Balneário Arroio do Silva (SC)";"Total";"Total";"9586";"4743";"4843"
"Balneário Camboriú (SC)";"Total";"Total";"108089";"51393";"56696"
"Balneário Barra do Sul (SC)";"Total";"Total";"8430";"4172";"4258"
"Balneário Gaivota (SC)";"Total";"Total";"8234";"4092";"4142"
"Bandeirante (SC)";"Total";"Total";"2906";"1535";"1371"
"Barra Bonita (SC)";"Total";"Total";"1878";"976";"902"
"Barra Velha (SC)";"Total";"Total";"22386";"11103";"11283"
"Bela Vista do Toldo (SC)";"Total";"Total";"6004";"3104";"2900"
"Belmonte (SC)";"Total";"Total";"2635";"1358";"1277"
"Benedito Novo (SC)";"Total";"Total";"10336";"5280";"5056"
"Biguaçu (SC)";"Total";"Total";"58206";"28665";"29541"
"Blumenau (SC)";"Total";"Total";"309011";"151542";"157469"
"Bocaina do Sul (SC)";"Total";"Total";"3290";"1700";"1590"
"Bombinhas (SC)";"Total";"Total";"14293";"7194";"7099"
"Bom Jardim da Serra (SC)";"Total";"Total";"4395";"2253";"2142"
"Bom Jesus (SC)";"Total";"Total";"2526";"1253";"1273"
"Bom Jesus do Oeste (SC)";"Total";"Total";"2132";"1078";"1054"
"Bom Retiro (SC)";"Total";"Total";"8942";"4513";"4429"
"Botuverá (SC)";"Total";"Total";"4468";"2278";"2190"
"Braço do Norte (SC)";"Total";"Total";"29018";"14533";"14485"
"Braço do Trombudo (SC)";"Total";"Total";"3457";"1765";"1692"
"Brunópolis (SC)";"Total";"Total";"2850";"1452";"1398"
"Brusque (SC)";"Total";"Total";"105503";"52400";"53103"
"Caçador (SC)";"Total";"Total";"70762";"35040";"35722"
"Caibi (SC)";"Total";"Total";"6219";"3142";"3077"
"Calmon (SC)";"Total";"Total";"3387";"1749";"1638"
"Camboriú (SC)";"Total";"Total";"62361";"31159";"31202"
"Capão Alto (SC)";"Total";"Total";"2753";"1431";"1322"
"Campo Alegre (SC)";"Total";"Total";"11748";"5970";"5778"
"Campo Belo do Sul (SC)";"Total";"Total";"7483";"3850";"3633"
"Campo Erê (SC)";"Total";"Total";"9370";"4686";"4684"
"Campos Novos (SC)";"Total";"Total";"32824";"16257";"16567"
"Canelinha (SC)";"Total";"Total";"10603";"5372";"5231"
"Canoinhas (SC)";"Total";"Total";"52765";"26044";"26721"
"Capinzal (SC)";"Total";"Total";"20769";"10233";"10536"
"Capivari de Baixo (SC)";"Total";"Total";"21674";"10499";"11175"
"Catanduvas (SC)";"Total";"Total";"9555";"4763";"4792"
"Caxambu do Sul (SC)";"Total";"Total";"4411";"2219";"2192"
"Celso Ramos (SC)";"Total";"Total";"2771";"1395";"1376"
"Cerro Negro (SC)";"Total";"Total";"3581";"1873";"1708"
"Chapadão do Lageado (SC)";"Total";"Total";"2762";"1425";"1337"
"Chapecó (SC)";"Total";"Total";"183530";"90626";"92904"
"Cocal do Sul (SC)";"Total";"Total";"15159";"7523";"7636"
"Concórdia (SC)";"Total";"Total";"68621";"33771";"34850"
"Cordilheira Alta (SC)";"Total";"Total";"3767";"1921";"1846"
"Coronel Freitas (SC)";"Total";"Total";"10213";"5189";"5024"
"Coronel Martins (SC)";"Total";"Total";"2458";"1262";"1196"
"Corupá (SC)";"Total";"Total";"13852";"7002";"6850"
"Correia Pinto (SC)";"Total";"Total";"14785";"7376";"7409"
"Criciúma (SC)";"Total";"Total";"192308";"94607";"97701"
"Cunha Porã (SC)";"Total";"Total";"10613";"5258";"5355"
"Cunhataí (SC)";"Total";"Total";"1882";"1004";"878"
"Curitibanos (SC)";"Total";"Total";"37748";"18521";"19227"
"Descanso (SC)";"Total";"Total";"8634";"4356";"4278"
"Dionísio Cerqueira (SC)";"Total";"Total";"14811";"7414";"7397"
"Dona Emma (SC)";"Total";"Total";"3721";"1909";"1812"
"Doutor Pedrinho (SC)";"Total";"Total";"3604";"1794";"1810"
"Entre Rios (SC)";"Total";"Total";"3018";"1557";"1461"
"Ermo (SC)";"Total";"Total";"2050";"1066";"984"
"Erval Velho (SC)";"Total";"Total";"4352";"2148";"2204"
"Faxinal dos Guedes (SC)";"Total";"Total";"10661";"5357";"5304"
"Flor do Sertão (SC)";"Total";"Total";"1588";"827";"761"
"Florianópolis (SC)";"Total";"Total";"421240";"203047";"218193"
"Formosa do Sul (SC)";"Total";"Total";"2601";"1327";"1274"
"Forquilhinha (SC)";"Total";"Total";"22548";"11307";"11241"
"Fraiburgo (SC)";"Total";"Total";"34553";"17161";"17392"
"Frei Rogério (SC)";"Total";"Total";"2474";"1288";"1186"
"Galvão (SC)";"Total";"Total";"3472";"1720";"1752"
"Garopaba (SC)";"Total";"Total";"18138";"9127";"9011"
"Garuva (SC)";"Total";"Total";"14761";"7540";"7221"
"Gaspar (SC)";"Total";"Total";"57981";"28678";"29303"
"Governador Celso Ramos (SC)";"Total";"Total";"12999";"6641";"6358"
"Grão-Pará (SC)";"Total";"Total";"6223";"3235";"2988"
"Gravatal (SC)";"Total";"Total";"10635";"5286";"5349"
"Guabiruba (SC)";"Total";"Total";"18430";"9351";"9079"
"Guaraciaba (SC)";"Total";"Total";"10498";"5300";"5198"
"Guaramirim (SC)";"Total";"Total";"35172";"17840";"17332"
"Guarujá do Sul (SC)";"Total";"Total";"4908";"2401";"2507"
"Guatambú (SC)";"Total";"Total";"4679";"2471";"2208"
"Herval d'Oeste (SC)";"Total";"Total";"21239";"10497";"10742"
"Ibiam (SC)";"Total";"Total";"1945";"981";"964"
"Ibicaré (SC)";"Total";"Total";"3373";"1775";"1598"
"Ibirama (SC)";"Total";"Total";"17330";"8666";"8664"
"Içara (SC)";"Total";"Total";"58833";"29303";"29530"
"Ilhota (SC)";"Total";"Total";"12355";"6227";"6128"
"Imaruí (SC)";"Total";"Total";"11672";"5865";"5807"
"Imbituba (SC)";"Total";"Total";"40170";"19805";"20365"
"Imbuia (SC)";"Total";"Total";"5707";"2890";"2817"
"Indaial (SC)";"Total";"Total";"54854";"27431";"27423"
"Iomerê (SC)";"Total";"Total";"2739";"1393";"1346"
"Ipira (SC)";"Total";"Total";"4752";"2366";"2386"
"Iporã do Oeste (SC)";"Total";"Total";"8409";"4258";"4151"
"Ipuaçu (SC)";"Total";"Total";"6798";"3473";"3325"
"Ipumirim (SC)";"Total";"Total";"7220";"3665";"3555"
"Iraceminha (SC)";"Total";"Total";"4253";"2172";"2081"
"Irani (SC)";"Total";"Total";"9531";"4850";"4681"
"Irati (SC)";"Total";"Total";"2096";"1072";"1024"
"Irineópolis (SC)";"Total";"Total";"10448";"5346";"5102"
"Itá (SC)";"Total";"Total";"6426";"3218";"3208"
"Itaiópolis (SC)";"Total";"Total";"20301";"10409";"9892"
"Itajaí (SC)";"Total";"Total";"183373";"90111";"93262"
"Itapema (SC)";"Total";"Total";"45797";"22391";"23406"
"Itapiranga (SC)";"Total";"Total";"15409";"7858";"7551"
"Itapoá (SC)";"Total";"Total";"14763";"7447";"7316"
"Ituporanga (SC)";"Total";"Total";"22250";"11095";"11155"
"Jaborá (SC)";"Total";"Total";"4041";"2013";"2028"
"Jacinto Machado (SC)";"Total";"Total";"10609";"5262";"5347"
"Jaguaruna (SC)";"Total";"Total";"17290";"8625";"8665"
"Jaraguá do Sul (SC)";"Total";"Total";"143123";"71801";"71322"
"Jardinópolis (SC)";"Total";"Total";"1766";"900";"866"
"Joaçaba (SC)";"Total";"Total";"27020";"13008";"14012"
"Joinville (SC)";"Total";"Total";"515288";"255756";"259532"
"José Boiteux (SC)";"Total";"Total";"4721";"2392";"2329"
"Jupiá (SC)";"Total";"Total";"2148";"1094";"1054"
"Lacerdópolis (SC)";"Total";"Total";"2199";"1096";"1103"
"Lages (SC)";"Total";"Total";"156727";"75952";"80775"
"Laguna (SC)";"Total";"Total";"51562";"25305";"26257"
"Lajeado Grande (SC)";"Total";"Total";"1490";"756";"734"
"Laurentino (SC)";"Total";"Total";"6004";"3001";"3003"
"Lauro Müller (SC)";"Total";"Total";"14367";"7187";"7180"
"Lebon Régis (SC)";"Total";"Total";"11838";"6081";"5757"
"Leoberto Leal (SC)";"Total";"Total";"3365";"1754";"1611"
"Lindóia do Sul (SC)";"Total";"Total";"4642";"2393";"2249"
"Lontras (SC)";"Total";"Total";"10244";"5126";"5118"
"Luiz Alves (SC)";"Total";"Total";"10438";"5383";"5055"
"Luzerna (SC)";"Total";"Total";"5600";"2740";"2860"
"Macieira (SC)";"Total";"Total";"1826";"948";"878"
"Mafra (SC)";"Total";"Total";"52912";"26251";"26661"
"Major Gercino (SC)";"Total";"Total";"3279";"1672";"1607"
"Major Vieira (SC)";"Total";"Total";"7479";"3799";"3680"
"Maracajá (SC)";"Total";"Total";"6404";"3248";"3156"
"Maravilha (SC)";"Total";"Total";"22101";"10907";"11194"
"Marema (SC)";"Total";"Total";"2203";"1135";"1068"
"Massaranduba (SC)";"Total";"Total";"14674";"7449";"7225"
"Matos Costa (SC)";"Total";"Total";"2839";"1475";"1364"
"Meleiro (SC)";"Total";"Total";"7000";"3458";"3542"
"Mirim Doce (SC)";"Total";"Total";"2513";"1273";"1240"
"Modelo (SC)";"Total";"Total";"4045";"2070";"1975"
"Mondaí (SC)";"Total";"Total";"10231";"5422";"4809"
"Monte Carlo (SC)";"Total";"Total";"9312";"4740";"4572"
"Monte Castelo (SC)";"Total";"Total";"8346";"4283";"4063"
"Morro da Fumaça (SC)";"Total";"Total";"16126";"8078";"8048"
"Morro Grande (SC)";"Total";"Total";"2890";"1513";"1377"
"Navegantes (SC)";"Total";"Total";"60556";"30158";"30398"
"Nova Erechim (SC)";"Total";"Total";"4275";"2205";"2070"
"Nova Itaberaba (SC)";"Total";"Total";"4267";"2210";"2057"
"Nova Trento (SC)";"Total";"Total";"12190";"6181";"6009"
"Nova Veneza (SC)";"Total";"Total";"13309";"6719";"6590"
"Novo Horizonte (SC)";"Total";"Total";"2750";"1450";"1300"
"Orleans (SC)";"Total";"Total";"21393";"10634";"10759"
"Otacílio Costa (SC)";"Total";"Total";"16337";"8262";"8075"
"Ouro (SC)";"Total";"Total";"7372";"3671";"3701"
"Ouro Verde (SC)";"Total";"Total";"2271";"1150";"1121"
"Paial (SC)";"Total";"Total";"1763";"939";"824"
"Painel (SC)";"Total";"Total";"2353";"1232";"1121"
"Palhoça (SC)";"Total";"Total";"137334";"68436";"68898"
"Palma Sola (SC)";"Total";"Total";"7765";"3957";"3808"
"Palmeira (SC)";"Total";"Total";"2373";"1221";"1152"
"Palmitos (SC)";"Total";"Total";"16020";"8018";"8002"
"Papanduva (SC)";"Total";"Total";"17928";"9172";"8756"
"Paraíso (SC)";"Total";"Total";"4080";"2091";"1989"
"Passo de Torres (SC)";"Total";"Total";"6627";"3352";"3275"
"Passos Maia (SC)";"Total";"Total";"4425";"2241";"2184"
"Paulo Lopes (SC)";"Total";"Total";"6692";"3404";"3288"
"Pedras Grandes (SC)";"Total";"Total";"4107";"2098";"2009"
"Penha (SC)";"Total";"Total";"25141";"12538";"12603"
"Peritiba (SC)";"Total";"Total";"2988";"1484";"1504"
"Petrolândia (SC)";"Total";"Total";"6131";"3165";"2966"
"Balneário Piçarras (SC)";"Total";"Total";"17078";"8521";"8557"
"Pinhalzinho (SC)";"Total";"Total";"16332";"8177";"8155"
"Pinheiro Preto (SC)";"Total";"Total";"3147";"1616";"1531"
"Piratuba (SC)";"Total";"Total";"4786";"2373";"2413"
"Planalto Alegre (SC)";"Total";"Total";"2654";"1383";"1271"
"Pomerode (SC)";"Total";"Total";"27759";"13904";"13855"
"Ponte Alta (SC)";"Total";"Total";"4894";"2454";"2440"
"Ponte Alta do Norte (SC)";"Total";"Total";"3303";"1644";"1659"
"Ponte Serrada (SC)";"Total";"Total";"11031";"5534";"5497"
"Porto Belo (SC)";"Total";"Total";"16083";"7998";"8085"
"Porto União (SC)";"Total";"Total";"33493";"16448";"17045"
"Pouso Redondo (SC)";"Total";"Total";"14810";"7504";"7306"
"Praia Grande (SC)";"Total";"Total";"7267";"3658";"3609"
"Presidente Castello Branco (SC)";"Total";"Total";"1725";"881";"844"
"Presidente Getúlio (SC)";"Total";"Total";"14887";"7404";"7483"
"Presidente Nereu (SC)";"Total";"Total";"2284";"1167";"1117"
"Princesa (SC)";"Total";"Total";"2758";"1421";"1337"
"Quilombo (SC)";"Total";"Total";"10248";"5168";"5080"
"Rancho Queimado (SC)";"Total";"Total";"2748";"1398";"1350"
"Rio das Antas (SC)";"Total";"Total";"6143";"3153";"2990"
"Rio do Campo (SC)";"Total";"Total";"6192";"3179";"3013"
"Rio do Oeste (SC)";"Total";"Total";"7090";"3599";"3491"
"Rio dos Cedros (SC)";"Total";"Total";"10284";"5268";"5016"
"Rio do Sul (SC)";"Total";"Total";"61198";"29978";"31220"
"Rio Fortuna (SC)";"Total";"Total";"4446";"2294";"2152"
"Rio Negrinho (SC)";"Total";"Total";"39846";"19977";"19869"
"Rio Rufino (SC)";"Total";"Total";"2436";"1245";"1191"
"Riqueza (SC)";"Total";"Total";"4838";"2498";"2340"
"Rodeio (SC)";"Total";"Total";"10922";"5487";"5435"
"Romelândia (SC)";"Total";"Total";"5551";"2793";"2758"
"Salete (SC)";"Total";"Total";"7370";"3772";"3598"
"Saltinho (SC)";"Total";"Total";"3961";"2040";"1921"
"Salto Veloso (SC)";"Total";"Total";"4301";"2189";"2112"
"Sangão (SC)";"Total";"Total";"10400";"5322";"5078"
"Santa Cecília (SC)";"Total";"Total";"15757";"7849";"7908"
"Santa Helena (SC)";"Total";"Total";"2382";"1236";"1146"
"Santa Rosa de Lima (SC)";"Total";"Total";"2065";"1092";"973"
"Santa Rosa do Sul (SC)";"Total";"Total";"8054";"4050";"4004"
"Santa Terezinha (SC)";"Total";"Total";"8767";"4700";"4067"
"Santa Terezinha do Progresso (SC)";"Total";"Total";"2896";"1493";"1403"
"Santiago do Sul (SC)";"Total";"Total";"1465";"754";"711"
"Santo Amaro da Imperatriz (SC)";"Total";"Total";"19823";"9984";"9839"
"São Bernardino (SC)";"Total";"Total";"2677";"1407";"1270"
"São Bento do Sul (SC)";"Total";"Total";"74801";"37239";"37562"
"São Bonifácio (SC)";"Total";"Total";"3008";"1551";"1457"
"São Carlos (SC)";"Total";"Total";"10291";"5171";"5120"
"São Cristóvão do Sul (SC)";"Total";"Total";"5012";"2850";"2162"
"São Domingos (SC)";"Total";"Total";"9491";"4780";"4711"
"São Francisco do Sul (SC)";"Total";"Total";"42520";"21182";"21338"
"São João do Oeste (SC)";"Total";"Total";"6036";"3098";"2938"
"São João Batista (SC)";"Total";"Total";"26260";"13287";"12973"
"São João do Itaperiú (SC)";"Total";"Total";"3435";"1790";"1645"
"São João do Sul (SC)";"Total";"Total";"7002";"3530";"3472"
"São Joaquim (SC)";"Total";"Total";"24812";"12434";"12378"
"São José (SC)";"Total";"Total";"209804";"101392";"108412"
"São José do Cedro (SC)";"Total";"Total";"13684";"6892";"6792"
"São José do Cerrito (SC)";"Total";"Total";"9273";"4801";"4472"
"São Lourenço do Oeste (SC)";"Total";"Total";"21792";"10828";"10964"
"São Ludgero (SC)";"Total";"Total";"10993";"5625";"5368"
"São Martinho (SC)";"Total";"Total";"3209";"1660";"1549"
"São Miguel da Boa Vista (SC)";"Total";"Total";"1904";"979";"925"
"São Miguel do Oeste (SC)";"Total";"Total";"36306";"17650";"18656"
"São Pedro de Alcântara (SC)";"Total";"Total";"4704";"2988";"1716"
"Saudades (SC)";"Total";"Total";"9016";"4618";"4398"
"Schroeder (SC)";"Total";"Total";"15316";"7801";"7515"
"Seara (SC)";"Total";"Total";"16936";"8525";"8411"
"Serra Alta (SC)";"Total";"Total";"3285";"1634";"1651"
"Siderópolis (SC)";"Total";"Total";"12998";"6480";"6518"
"Sombrio (SC)";"Total";"Total";"26613";"13072";"13541"
"Sul Brasil (SC)";"Total";"Total";"2766";"1437";"1329"
"Taió (SC)";"Total";"Total";"17260";"8690";"8570"
"Tangará (SC)";"Total";"Total";"8674";"4470";"4204"
"Tigrinhos (SC)";"Total";"Total";"1757";"902";"855"
"Tijucas (SC)";"Total";"Total";"30960";"15494";"15466"
"Timbé do Sul (SC)";"Total";"Total";"5308";"2693";"2615"
"Timbó (SC)";"Total";"Total";"36774";"18244";"18530"
"Timbó Grande (SC)";"Total";"Total";"7167";"3612";"3555"
"Três Barras (SC)";"Total";"Total";"18129";"9057";"9072"
"Treviso (SC)";"Total";"Total";"3527";"1789";"1738"
"Treze de Maio (SC)";"Total";"Total";"6876";"3451";"3425"
"Treze Tílias (SC)";"Total";"Total";"6341";"3150";"3191"
"Trombudo Central (SC)";"Total";"Total";"6553";"3268";"3285"
"Tubarão (SC)";"Total";"Total";"97235";"47114";"50121"
"Tunápolis (SC)";"Total";"Total";"4633";"2368";"2265"
"Turvo (SC)";"Total";"Total";"11854";"5850";"6004"
"União do Oeste (SC)";"Total";"Total";"2910";"1475";"1435"
"Urubici (SC)";"Total";"Total";"10699";"5396";"5303"
"Urupema (SC)";"Total";"Total";"2482";"1274";"1208"
"Urussanga (SC)";"Total";"Total";"20223";"9935";"10288"
"Vargeão (SC)";"Total";"Total";"3532";"1785";"1747"
"Vargem (SC)";"Total";"Total";"2808";"1446";"1362"
"Vargem Bonita (SC)";"Total";"Total";"4793";"2428";"2365"
"Vidal Ramos (SC)";"Total";"Total";"6290";"3258";"3032"
"Videira (SC)";"Total";"Total";"47188";"23279";"23909"
"Vitor Meireles (SC)";"Total";"Total";"5207";"2770";"2437"
"Witmarsum (SC)";"Total";"Total";"3600";"1827";"1773"
"Xanxerê (SC)";"Total";"Total";"44128";"21581";"22547"
"Xavantina (SC)";"Total";"Total";"4142";"2160";"1982"
"Xaxim (SC)";"Total";"Total";"25713";"12776";"12937"
"Zortéa (SC)";"Total";"Total";"2991";"1537";"1454"
"Aceguá (RS)";"Total";"Total";"4394";"2303";"2091"
"Água Santa (RS)";"Total";"Total";"3722";"1879";"1843"
"Agudo (RS)";"Total";"Total";"16722";"8349";"8373"
"Ajuricaba (RS)";"Total";"Total";"7255";"3585";"3670"
"Alecrim (RS)";"Total";"Total";"7045";"3512";"3533"
"Alegrete (RS)";"Total";"Total";"77653";"38051";"39602"
"Alegria (RS)";"Total";"Total";"4301";"2149";"2152"
"Almirante Tamandaré do Sul (RS)";"Total";"Total";"2067";"1041";"1026"
"Alpestre (RS)";"Total";"Total";"8027";"4129";"3898"
"Alto Alegre (RS)";"Total";"Total";"1848";"944";"904"
"Alto Feliz (RS)";"Total";"Total";"2917";"1500";"1417"
"Alvorada (RS)";"Total";"Total";"195673";"95080";"100593"
"Amaral Ferrador (RS)";"Total";"Total";"6353";"3281";"3072"
"Ametista do Sul (RS)";"Total";"Total";"7323";"3732";"3591"
"André da Rocha (RS)";"Total";"Total";"1216";"620";"596"
"Anta Gorda (RS)";"Total";"Total";"6073";"3025";"3048"
"Antônio Prado (RS)";"Total";"Total";"12833";"6405";"6428"
"Arambaré (RS)";"Total";"Total";"3693";"1854";"1839"
"Araricá (RS)";"Total";"Total";"4864";"2456";"2408"
"Aratiba (RS)";"Total";"Total";"6565";"3340";"3225"
"Arroio do Meio (RS)";"Total";"Total";"18783";"9353";"9430"
"Arroio do Sal (RS)";"Total";"Total";"7740";"3833";"3907"
"Arroio do Padre (RS)";"Total";"Total";"2730";"1414";"1316"
"Arroio dos Ratos (RS)";"Total";"Total";"13606";"6635";"6971"
"Arroio do Tigre (RS)";"Total";"Total";"12648";"6384";"6264"
"Arroio Grande (RS)";"Total";"Total";"18470";"9174";"9296"
"Arvorezinha (RS)";"Total";"Total";"10225";"5134";"5091"
"Augusto Pestana (RS)";"Total";"Total";"7096";"3487";"3609"
"Áurea (RS)";"Total";"Total";"3665";"1807";"1858"
"Bagé (RS)";"Total";"Total";"116794";"55804";"60990"
"Balneário Pinhal (RS)";"Total";"Total";"10856";"5344";"5512"
"Barão (RS)";"Total";"Total";"5741";"2912";"2829"
"Barão de Cotegipe (RS)";"Total";"Total";"6529";"3296";"3233"
"Barão do Triunfo (RS)";"Total";"Total";"7018";"3741";"3277"
"Barracão (RS)";"Total";"Total";"5357";"2691";"2666"
"Barra do Guarita (RS)";"Total";"Total";"3089";"1550";"1539"
"Barra do Quaraí (RS)";"Total";"Total";"4012";"2128";"1884"
"Barra do Ribeiro (RS)";"Total";"Total";"12572";"6253";"6319"
"Barra do Rio Azul (RS)";"Total";"Total";"2003";"1049";"954"
"Barra Funda (RS)";"Total";"Total";"2367";"1177";"1190"
"Barros Cassal (RS)";"Total";"Total";"11133";"5729";"5404"
"Benjamin Constant do Sul (RS)";"Total";"Total";"2307";"1195";"1112"
"Bento Gonçalves (RS)";"Total";"Total";"107278";"52645";"54633"
"Boa Vista das Missões (RS)";"Total";"Total";"2114";"1056";"1058"
"Boa Vista do Buricá (RS)";"Total";"Total";"6574";"3295";"3279"
"Boa Vista do Cadeado (RS)";"Total";"Total";"2441";"1257";"1184"
"Boa Vista do Incra (RS)";"Total";"Total";"2425";"1243";"1182"
"Boa Vista do Sul (RS)";"Total";"Total";"2776";"1469";"1307"
"Bom Jesus (RS)";"Total";"Total";"11519";"5703";"5816"
"Bom Princípio (RS)";"Total";"Total";"11789";"6029";"5760"
"Bom Progresso (RS)";"Total";"Total";"2328";"1167";"1161"
"Bom Retiro do Sul (RS)";"Total";"Total";"11472";"5655";"5817"
"Boqueirão do Leão (RS)";"Total";"Total";"7673";"3937";"3736"
"Bossoroca (RS)";"Total";"Total";"6884";"3509";"3375"
"Bozano (RS)";"Total";"Total";"2200";"1100";"1100"
"Braga (RS)";"Total";"Total";"3702";"1866";"1836"
"Brochier (RS)";"Total";"Total";"4675";"2398";"2277"
"Butiá (RS)";"Total";"Total";"20406";"10032";"10374"
"Caçapava do Sul (RS)";"Total";"Total";"33690";"16329";"17361"
"Cacequi (RS)";"Total";"Total";"13676";"6836";"6840"
"Cachoeira do Sul (RS)";"Total";"Total";"83827";"40378";"43449"
"Cachoeirinha (RS)";"Total";"Total";"118278";"57173";"61105"
"Cacique Doble (RS)";"Total";"Total";"4868";"2417";"2451"
"Caibaté (RS)";"Total";"Total";"4954";"2532";"2422"
"Caiçara (RS)";"Total";"Total";"5071";"2585";"2486"
"Camaquã (RS)";"Total";"Total";"62764";"30900";"31864"
"Camargo (RS)";"Total";"Total";"2592";"1291";"1301"
"Cambará do Sul (RS)";"Total";"Total";"6542";"3350";"3192"
"Campestre da Serra (RS)";"Total";"Total";"3247";"1674";"1573"
"Campina das Missões (RS)";"Total";"Total";"6117";"3056";"3061"
"Campinas do Sul (RS)";"Total";"Total";"5506";"2650";"2856"
"Campo Bom (RS)";"Total";"Total";"60074";"29471";"30603"
"Campo Novo (RS)";"Total";"Total";"5459";"2685";"2774"
"Campos Borges (RS)";"Total";"Total";"3494";"1754";"1740"
"Candelária (RS)";"Total";"Total";"30171";"14752";"15419"
"Cândido Godói (RS)";"Total";"Total";"6535";"3318";"3217"
"Candiota (RS)";"Total";"Total";"8771";"4481";"4290"
"Canela (RS)";"Total";"Total";"39229";"19120";"20109"
"Canguçu (RS)";"Total";"Total";"53259";"26856";"26403"
"Canoas (RS)";"Total";"Total";"323827";"155936";"167891"
"Canudos do Vale (RS)";"Total";"Total";"1807";"959";"848"
"Capão Bonito do Sul (RS)";"Total";"Total";"1754";"943";"811"
"Capão da Canoa (RS)";"Total";"Total";"42040";"20616";"21424"
"Capão do Cipó (RS)";"Total";"Total";"3104";"1628";"1476"
"Capão do Leão (RS)";"Total";"Total";"24298";"11962";"12336"
"Capivari do Sul (RS)";"Total";"Total";"3890";"1935";"1955"
"Capela de Santana (RS)";"Total";"Total";"11612";"5848";"5764"
"Capitão (RS)";"Total";"Total";"2636";"1353";"1283"
"Carazinho (RS)";"Total";"Total";"59317";"28280";"31037"
"Caraá (RS)";"Total";"Total";"7312";"3798";"3514"
"Carlos Barbosa (RS)";"Total";"Total";"25192";"12662";"12530"
"Carlos Gomes (RS)";"Total";"Total";"1607";"834";"773"
"Casca (RS)";"Total";"Total";"8651";"4243";"4408"
"Caseiros (RS)";"Total";"Total";"3007";"1517";"1490"
"Catuípe (RS)";"Total";"Total";"9323";"4590";"4733"
"Caxias do Sul (RS)";"Total";"Total";"435564";"213612";"221952"
"Centenário (RS)";"Total";"Total";"2965";"1541";"1424"
"Cerrito (RS)";"Total";"Total";"6402";"3213";"3189"
"Cerro Branco (RS)";"Total";"Total";"4454";"2225";"2229"
"Cerro Grande (RS)";"Total";"Total";"2417";"1209";"1208"
"Cerro Grande do Sul (RS)";"Total";"Total";"10268";"5355";"4913"
"Cerro Largo (RS)";"Total";"Total";"13289";"6617";"6672"
"Chapada (RS)";"Total";"Total";"9377";"4593";"4784"
"Charqueadas (RS)";"Total";"Total";"35320";"19533";"15787"
"Charrua (RS)";"Total";"Total";"3471";"1728";"1743"
"Chiapetta (RS)";"Total";"Total";"4044";"1975";"2069"
"Chuí (RS)";"Total";"Total";"5917";"2921";"2996"
"Chuvisca (RS)";"Total";"Total";"4944";"2603";"2341"
"Cidreira (RS)";"Total";"Total";"12668";"6245";"6423"
"Ciríaco (RS)";"Total";"Total";"4922";"2512";"2410"
"Colinas (RS)";"Total";"Total";"2420";"1208";"1212"
"Colorado (RS)";"Total";"Total";"3550";"1727";"1823"
"Condor (RS)";"Total";"Total";"6552";"3219";"3333"
"Constantina (RS)";"Total";"Total";"9752";"4776";"4976"
"Coqueiro Baixo (RS)";"Total";"Total";"1528";"791";"737"
"Coqueiros do Sul (RS)";"Total";"Total";"2457";"1255";"1202"
"Coronel Barros (RS)";"Total";"Total";"2459";"1219";"1240"
"Coronel Bicaco (RS)";"Total";"Total";"7748";"3802";"3946"
"Coronel Pilar (RS)";"Total";"Total";"1725";"894";"831"
"Cotiporã (RS)";"Total";"Total";"3917";"2033";"1884"
"Coxilha (RS)";"Total";"Total";"2826";"1388";"1438"
"Crissiumal (RS)";"Total";"Total";"14084";"6913";"7171"
"Cristal (RS)";"Total";"Total";"7280";"3686";"3594"
"Cristal do Sul (RS)";"Total";"Total";"2826";"1441";"1385"
"Cruz Alta (RS)";"Total";"Total";"62821";"29743";"33078"
"Cruzaltense (RS)";"Total";"Total";"2141";"1101";"1040"
"Cruzeiro do Sul (RS)";"Total";"Total";"12320";"6157";"6163"
"David Canabarro (RS)";"Total";"Total";"4683";"2410";"2273"
"Derrubadas (RS)";"Total";"Total";"3190";"1604";"1586"
"Dezesseis de Novembro (RS)";"Total";"Total";"2866";"1469";"1397"
"Dilermando de Aguiar (RS)";"Total";"Total";"3064";"1579";"1485"
"Dois Irmãos (RS)";"Total";"Total";"27572";"13653";"13919"
"Dois Irmãos das Missões (RS)";"Total";"Total";"2157";"1080";"1077"
"Dois Lajeados (RS)";"Total";"Total";"3278";"1653";"1625"
"Dom Feliciano (RS)";"Total";"Total";"14380";"7398";"6982"
"Dom Pedro de Alcântara (RS)";"Total";"Total";"2550";"1341";"1209"
"Dom Pedrito (RS)";"Total";"Total";"38898";"19107";"19791"
"Dona Francisca (RS)";"Total";"Total";"3401";"1678";"1723"
"Doutor Maurício Cardoso (RS)";"Total";"Total";"5313";"2646";"2667"
"Doutor Ricardo (RS)";"Total";"Total";"2030";"1035";"995"
"Eldorado do Sul (RS)";"Total";"Total";"34343";"16999";"17344"
"Encantado (RS)";"Total";"Total";"20510";"9932";"10578"
"Encruzilhada do Sul (RS)";"Total";"Total";"24534";"12322";"12212"
"Engenho Velho (RS)";"Total";"Total";"1527";"742";"785"
"Entre-Ijuís (RS)";"Total";"Total";"8938";"4415";"4523"
"Entre Rios do Sul (RS)";"Total";"Total";"3080";"1556";"1524"
"Erebango (RS)";"Total";"Total";"2970";"1490";"1480"
"Erechim (RS)";"Total";"Total";"96087";"46224";"49863"
"Ernestina (RS)";"Total";"Total";"3088";"1562";"1526"
"Herval (RS)";"Total";"Total";"6753";"3483";"3270"
"Erval Grande (RS)";"Total";"Total";"5163";"2622";"2541"
"Erval Seco (RS)";"Total";"Total";"7878";"3920";"3958"
"Esmeralda (RS)";"Total";"Total";"3168";"1572";"1596"
"Esperança do Sul (RS)";"Total";"Total";"3272";"1650";"1622"
"Espumoso (RS)";"Total";"Total";"15240";"7532";"7708"
"Estação (RS)";"Total";"Total";"6011";"2951";"3060"
"Estância Velha (RS)";"Total";"Total";"42574";"21035";"21539"
"Esteio (RS)";"Total";"Total";"80755";"38973";"41782"
"Estrela (RS)";"Total";"Total";"30619";"15119";"15500"
"Estrela Velha (RS)";"Total";"Total";"3628";"1846";"1782"
"Eugênio de Castro (RS)";"Total";"Total";"2798";"1415";"1383"
"Fagundes Varela (RS)";"Total";"Total";"2579";"1300";"1279"
"Farroupilha (RS)";"Total";"Total";"63635";"31303";"32332"
"Faxinal do Soturno (RS)";"Total";"Total";"6672";"3274";"3398"
"Faxinalzinho (RS)";"Total";"Total";"2567";"1283";"1284"
"Fazenda Vilanova (RS)";"Total";"Total";"3697";"1856";"1841"
"Feliz (RS)";"Total";"Total";"12359";"6161";"6198"
"Flores da Cunha (RS)";"Total";"Total";"27126";"13552";"13574"
"Floriano Peixoto (RS)";"Total";"Total";"2018";"1081";"937"
"Fontoura Xavier (RS)";"Total";"Total";"10719";"5461";"5258"
"Formigueiro (RS)";"Total";"Total";"7014";"3570";"3444"
"Forquetinha (RS)";"Total";"Total";"2479";"1265";"1214"
"Fortaleza dos Valos (RS)";"Total";"Total";"4575";"2241";"2334"
"Frederico Westphalen (RS)";"Total";"Total";"28843";"14128";"14715"
"Garibaldi (RS)";"Total";"Total";"30689";"15221";"15468"
"Garruchos (RS)";"Total";"Total";"3234";"1682";"1552"
"Gaurama (RS)";"Total";"Total";"5862";"2832";"3030"
"General Câmara (RS)";"Total";"Total";"8447";"4233";"4214"
"Gentil (RS)";"Total";"Total";"1677";"889";"788"
"Getúlio Vargas (RS)";"Total";"Total";"16154";"7849";"8305"
"Giruá (RS)";"Total";"Total";"17075";"8338";"8737"
"Glorinha (RS)";"Total";"Total";"6891";"3536";"3355"
"Gramado (RS)";"Total";"Total";"32273";"15673";"16600"
"Gramado dos Loureiros (RS)";"Total";"Total";"2269";"1151";"1118"
"Gramado Xavier (RS)";"Total";"Total";"3970";"2044";"1926"
"Gravataí (RS)";"Total";"Total";"255660";"124880";"130780"
"Guabiju (RS)";"Total";"Total";"1598";"806";"792"
"Guaíba (RS)";"Total";"Total";"95204";"46153";"49051"
"Guaporé (RS)";"Total";"Total";"22814";"11124";"11690"
"Guarani das Missões (RS)";"Total";"Total";"8115";"3951";"4164"
"Harmonia (RS)";"Total";"Total";"4254";"2151";"2103"
"Herveiras (RS)";"Total";"Total";"2954";"1543";"1411"
"Horizontina (RS)";"Total";"Total";"18348";"8946";"9402"
"Hulha Negra (RS)";"Total";"Total";"6043";"3124";"2919"
"Humaitá (RS)";"Total";"Total";"4919";"2387";"2532"
"Ibarama (RS)";"Total";"Total";"4371";"2230";"2141"
"Ibiaçá (RS)";"Total";"Total";"4710";"2290";"2420"
"Ibiraiaras (RS)";"Total";"Total";"7171";"3588";"3583"
"Ibirapuitã (RS)";"Total";"Total";"4061";"2063";"1998"
"Ibirubá (RS)";"Total";"Total";"19310";"9472";"9838"
"Igrejinha (RS)";"Total";"Total";"31660";"15461";"16199"
"Ijuí (RS)";"Total";"Total";"78915";"38112";"40803"
"Ilópolis (RS)";"Total";"Total";"4102";"2055";"2047"
"Imbé (RS)";"Total";"Total";"17670";"8663";"9007"
"Imigrante (RS)";"Total";"Total";"3023";"1495";"1528"
"Independência (RS)";"Total";"Total";"6618";"3293";"3325"
"Inhacorá (RS)";"Total";"Total";"2267";"1148";"1119"
"Ipê (RS)";"Total";"Total";"6016";"3083";"2933"
"Ipiranga do Sul (RS)";"Total";"Total";"1944";"972";"972"
"Iraí (RS)";"Total";"Total";"8078";"4075";"4003"
"Itaara (RS)";"Total";"Total";"5010";"2543";"2467"
"Itacurubi (RS)";"Total";"Total";"3441";"1778";"1663"
"Itapuca (RS)";"Total";"Total";"2344";"1233";"1111"
"Itaqui (RS)";"Total";"Total";"38159";"19034";"19125"
"Itati (RS)";"Total";"Total";"2584";"1340";"1244"
"Itatiba do Sul (RS)";"Total";"Total";"4171";"2178";"1993"
"Ivorá (RS)";"Total";"Total";"2156";"1097";"1059"
"Ivoti (RS)";"Total";"Total";"19874";"9801";"10073"
"Jaboticaba (RS)";"Total";"Total";"4098";"2081";"2017"
"Jacuizinho (RS)";"Total";"Total";"2507";"1283";"1224"
"Jacutinga (RS)";"Total";"Total";"3633";"1781";"1852"
"Jaguarão (RS)";"Total";"Total";"27931";"13588";"14343"
"Jaguari (RS)";"Total";"Total";"11473";"5738";"5735"
"Jaquirana (RS)";"Total";"Total";"4177";"2142";"2035"
"Jari (RS)";"Total";"Total";"3575";"1884";"1691"
"Jóia (RS)";"Total";"Total";"8331";"4306";"4025"
"Júlio de Castilhos (RS)";"Total";"Total";"19579";"9626";"9953"
"Lagoa Bonita do Sul (RS)";"Total";"Total";"2662";"1403";"1259"
"Lagoão (RS)";"Total";"Total";"6185";"3195";"2990"
"Lagoa dos Três Cantos (RS)";"Total";"Total";"1598";"776";"822"
"Lagoa Vermelha (RS)";"Total";"Total";"27525";"13564";"13961"
"Lajeado (RS)";"Total";"Total";"71445";"34731";"36714"
"Lajeado do Bugre (RS)";"Total";"Total";"2487";"1253";"1234"
"Lavras do Sul (RS)";"Total";"Total";"7679";"3775";"3904"
"Liberato Salzano (RS)";"Total";"Total";"5780";"2949";"2831"
"Lindolfo Collor (RS)";"Total";"Total";"5227";"2679";"2548"
"Linha Nova (RS)";"Total";"Total";"1624";"808";"816"
"Machadinho (RS)";"Total";"Total";"5510";"2757";"2753"
"Maçambará (RS)";"Total";"Total";"4738";"2418";"2320"
"Mampituba (RS)";"Total";"Total";"3003";"1551";"1452"
"Manoel Viana (RS)";"Total";"Total";"7072";"3556";"3516"
"Maquiné (RS)";"Total";"Total";"6905";"3523";"3382"
"Maratá (RS)";"Total";"Total";"2527";"1272";"1255"
"Marau (RS)";"Total";"Total";"36364";"18030";"18334"
"Marcelino Ramos (RS)";"Total";"Total";"5134";"2555";"2579"
"Mariana Pimentel (RS)";"Total";"Total";"3768";"1970";"1798"
"Mariano Moro (RS)";"Total";"Total";"2210";"1133";"1077"
"Marques de Souza (RS)";"Total";"Total";"4068";"2039";"2029"
"Mata (RS)";"Total";"Total";"5111";"2575";"2536"
"Mato Castelhano (RS)";"Total";"Total";"2470";"1292";"1178"
"Mato Leitão (RS)";"Total";"Total";"3865";"1937";"1928"
"Mato Queimado (RS)";"Total";"Total";"1799";"902";"897"
"Maximiliano de Almeida (RS)";"Total";"Total";"4911";"2467";"2444"
"Minas do Leão (RS)";"Total";"Total";"7631";"3778";"3853"
"Miraguaí (RS)";"Total";"Total";"4855";"2413";"2442"
"Montauri (RS)";"Total";"Total";"1542";"794";"748"
"Monte Alegre dos Campos (RS)";"Total";"Total";"3102";"1661";"1441"
"Monte Belo do Sul (RS)";"Total";"Total";"2670";"1345";"1325"
"Montenegro (RS)";"Total";"Total";"59415";"29245";"30170"
"Mormaço (RS)";"Total";"Total";"2749";"1396";"1353"
"Morrinhos do Sul (RS)";"Total";"Total";"3182";"1617";"1565"
"Morro Redondo (RS)";"Total";"Total";"6227";"3135";"3092"
"Morro Reuter (RS)";"Total";"Total";"5676";"2849";"2827"
"Mostardas (RS)";"Total";"Total";"12124";"6187";"5937"
"Muçum (RS)";"Total";"Total";"4791";"2300";"2491"
"Muitos Capões (RS)";"Total";"Total";"2988";"1535";"1453"
"Muliterno (RS)";"Total";"Total";"1813";"923";"890"
"Não-Me-Toque (RS)";"Total";"Total";"15936";"7855";"8081"
"Nicolau Vergueiro (RS)";"Total";"Total";"1721";"862";"859"
"Nonoai (RS)";"Total";"Total";"12074";"5932";"6142"
"Nova Alvorada (RS)";"Total";"Total";"3182";"1598";"1584"
"Nova Araçá (RS)";"Total";"Total";"4001";"1957";"2044"
"Nova Bassano (RS)";"Total";"Total";"8840";"4480";"4360"
"Nova Boa Vista (RS)";"Total";"Total";"1960";"981";"979"
"Nova Bréscia (RS)";"Total";"Total";"3184";"1629";"1555"
"Nova Candelária (RS)";"Total";"Total";"2751";"1405";"1346"
"Nova Esperança do Sul (RS)";"Total";"Total";"4671";"2306";"2365"
"Nova Hartz (RS)";"Total";"Total";"18346";"9072";"9274"
"Nova Pádua (RS)";"Total";"Total";"2450";"1258";"1192"
"Nova Palma (RS)";"Total";"Total";"6342";"3217";"3125"
"Nova Petrópolis (RS)";"Total";"Total";"19045";"9370";"9675"
"Nova Prata (RS)";"Total";"Total";"22830";"11303";"11527"
"Nova Ramada (RS)";"Total";"Total";"2437";"1246";"1191"
"Nova Roma do Sul (RS)";"Total";"Total";"3343";"1708";"1635"
"Nova Santa Rita (RS)";"Total";"Total";"22716";"11441";"11275"
"Novo Cabrais (RS)";"Total";"Total";"3855";"1946";"1909"
"Novo Hamburgo (RS)";"Total";"Total";"238940";"115766";"123174"
"Novo Machado (RS)";"Total";"Total";"3925";"1948";"1977"
"Novo Tiradentes (RS)";"Total";"Total";"2277";"1191";"1086"
"Novo Xingu (RS)";"Total";"Total";"1757";"861";"896"
"Novo Barreiro (RS)";"Total";"Total";"3978";"2032";"1946"
"Osório (RS)";"Total";"Total";"40906";"20157";"20749"
"Paim Filho (RS)";"Total";"Total";"4243";"2111";"2132"
"Palmares do Sul (RS)";"Total";"Total";"10969";"5462";"5507"
"Palmeira das Missões (RS)";"Total";"Total";"34328";"16641";"17687"
"Palmitinho (RS)";"Total";"Total";"6920";"3494";"3426"
"Panambi (RS)";"Total";"Total";"38058";"19013";"19045"
"Pantano Grande (RS)";"Total";"Total";"9895";"4909";"4986"
"Paraí (RS)";"Total";"Total";"6812";"3451";"3361"
"Paraíso do Sul (RS)";"Total";"Total";"7336";"3694";"3642"
"Pareci Novo (RS)";"Total";"Total";"3511";"1784";"1727"
"Parobé (RS)";"Total";"Total";"51502";"25449";"26053"
"Passa Sete (RS)";"Total";"Total";"5154";"2678";"2476"
"Passo do Sobrado (RS)";"Total";"Total";"6011";"2996";"3015"
"Passo Fundo (RS)";"Total";"Total";"184826";"88050";"96776"
"Paulo Bento (RS)";"Total";"Total";"2196";"1126";"1070"
"Paverama (RS)";"Total";"Total";"8044";"4050";"3994"
"Pedras Altas (RS)";"Total";"Total";"2212";"1161";"1051"
"Pedro Osório (RS)";"Total";"Total";"7811";"3826";"3985"
"Pejuçara (RS)";"Total";"Total";"3973";"2008";"1965"
"Pelotas (RS)";"Total";"Total";"328275";"154198";"174077"
"Picada Café (RS)";"Total";"Total";"5182";"2594";"2588"
"Pinhal (RS)";"Total";"Total";"2513";"1274";"1239"
"Pinhal da Serra (RS)";"Total";"Total";"2130";"1110";"1020"
"Pinhal Grande (RS)";"Total";"Total";"4471";"2314";"2157"
"Pinheirinho do Vale (RS)";"Total";"Total";"4497";"2277";"2220"
"Pinheiro Machado (RS)";"Total";"Total";"12780";"6381";"6399"
"Pirapó (RS)";"Total";"Total";"2757";"1398";"1359"
"Piratini (RS)";"Total";"Total";"19841";"10108";"9733"
"Planalto (RS)";"Total";"Total";"10524";"5209";"5315"
"Poço das Antas (RS)";"Total";"Total";"2017";"1023";"994"
"Pontão (RS)";"Total";"Total";"3857";"1984";"1873"
"Ponte Preta (RS)";"Total";"Total";"1750";"924";"826"
"Portão (RS)";"Total";"Total";"30920";"15515";"15405"
"Porto Alegre (RS)";"Total";"Total";"1409351";"653787";"755564"
"Porto Lucena (RS)";"Total";"Total";"5413";"2698";"2715"
"Porto Mauá (RS)";"Total";"Total";"2542";"1264";"1278"
"Porto Vera Cruz (RS)";"Total";"Total";"1852";"936";"916"
"Porto Xavier (RS)";"Total";"Total";"10558";"5300";"5258"
"Pouso Novo (RS)";"Total";"Total";"1875";"953";"922"
"Presidente Lucena (RS)";"Total";"Total";"2484";"1310";"1174"
"Progresso (RS)";"Total";"Total";"6163";"3183";"2980"
"Protásio Alves (RS)";"Total";"Total";"2000";"1079";"921"
"Putinga (RS)";"Total";"Total";"4141";"2097";"2044"
"Quaraí (RS)";"Total";"Total";"23021";"11228";"11793"
"Quatro Irmãos (RS)";"Total";"Total";"1775";"890";"885"
"Quevedos (RS)";"Total";"Total";"2710";"1447";"1263"
"Quinze de Novembro (RS)";"Total";"Total";"3653";"1799";"1854"
"Redentora (RS)";"Total";"Total";"10222";"5210";"5012"
"Relvado (RS)";"Total";"Total";"2155";"1071";"1084"
"Restinga Sêca (RS)";"Total";"Total";"15849";"7815";"8034"
"Rio dos Índios (RS)";"Total";"Total";"3616";"1860";"1756"
"Rio Grande (RS)";"Total";"Total";"197228";"94983";"102245"
"Rio Pardo (RS)";"Total";"Total";"37591";"18318";"19273"
"Riozinho (RS)";"Total";"Total";"4330";"2203";"2127"
"Roca Sales (RS)";"Total";"Total";"10284";"5090";"5194"
"Rodeio Bonito (RS)";"Total";"Total";"5743";"2846";"2897"
"Rolador (RS)";"Total";"Total";"2546";"1318";"1228"
"Rolante (RS)";"Total";"Total";"19485";"9767";"9718"
"Ronda Alta (RS)";"Total";"Total";"10221";"5009";"5212"
"Rondinha (RS)";"Total";"Total";"5518";"2718";"2800"
"Roque Gonzales (RS)";"Total";"Total";"7203";"3622";"3581"
"Rosário do Sul (RS)";"Total";"Total";"39707";"19311";"20396"
"Sagrada Família (RS)";"Total";"Total";"2595";"1339";"1256"
"Saldanha Marinho (RS)";"Total";"Total";"2869";"1390";"1479"
"Salto do Jacuí (RS)";"Total";"Total";"11880";"5878";"6002"
"Salvador das Missões (RS)";"Total";"Total";"2669";"1377";"1292"
"Salvador do Sul (RS)";"Total";"Total";"6747";"3412";"3335"
"Sananduva (RS)";"Total";"Total";"15373";"7604";"7769"
"Santa Bárbara do Sul (RS)";"Total";"Total";"8829";"4341";"4488"
"Santa Cecília do Sul (RS)";"Total";"Total";"1655";"839";"816"
"Santa Clara do Sul (RS)";"Total";"Total";"5697";"2845";"2852"
"Santa Cruz do Sul (RS)";"Total";"Total";"118374";"56943";"61431"
"Santa Maria (RS)";"Total";"Total";"261031";"123634";"137397"
"Santa Maria do Herval (RS)";"Total";"Total";"6053";"3101";"2952"
"Santa Margarida do Sul (RS)";"Total";"Total";"2352";"1272";"1080"
"Santana da Boa Vista (RS)";"Total";"Total";"8242";"4169";"4073"
"Sant'Ana do Livramento (RS)";"Total";"Total";"82464";"39376";"43088"
"Santa Rosa (RS)";"Total";"Total";"68587";"33483";"35104"
"Santa Tereza (RS)";"Total";"Total";"1720";"889";"831"
"Santa Vitória do Palmar (RS)";"Total";"Total";"30990";"15469";"15521"
"Santiago (RS)";"Total";"Total";"49071";"23571";"25500"
"Santo Ângelo (RS)";"Total";"Total";"76275";"36586";"39689"
"Santo Antônio do Palma (RS)";"Total";"Total";"2139";"1112";"1027"
"Santo Antônio da Patrulha (RS)";"Total";"Total";"39685";"19756";"19929"
"Santo Antônio das Missões (RS)";"Total";"Total";"11210";"5579";"5631"
"Santo Antônio do Planalto (RS)";"Total";"Total";"1987";"980";"1007"
"Santo Augusto (RS)";"Total";"Total";"13968";"6811";"7157"
"Santo Cristo (RS)";"Total";"Total";"14378";"7190";"7188"
"Santo Expedito do Sul (RS)";"Total";"Total";"2461";"1239";"1222"
"São Borja (RS)";"Total";"Total";"61671";"30248";"31423"
"São Domingos do Sul (RS)";"Total";"Total";"2926";"1470";"1456"
"São Francisco de Assis (RS)";"Total";"Total";"19254";"9493";"9761"
"São Francisco de Paula (RS)";"Total";"Total";"20537";"10402";"10135"
"São Gabriel (RS)";"Total";"Total";"60425";"29429";"30996"
"São Jerônimo (RS)";"Total";"Total";"22134";"11026";"11108"
"São João da Urtiga (RS)";"Total";"Total";"4726";"2401";"2325"
"São João do Polêsine (RS)";"Total";"Total";"2635";"1272";"1363"
"São Jorge (RS)";"Total";"Total";"2774";"1379";"1395"
"São José das Missões (RS)";"Total";"Total";"2720";"1377";"1343"
"São José do Herval (RS)";"Total";"Total";"2204";"1136";"1068"
"São José do Hortêncio (RS)";"Total";"Total";"4094";"2088";"2006"
"São José do Inhacorá (RS)";"Total";"Total";"2200";"1125";"1075"
"São José do Norte (RS)";"Total";"Total";"25503";"13003";"12500"
"São José do Ouro (RS)";"Total";"Total";"6904";"3382";"3522"
"São José do Sul (RS)";"Total";"Total";"2082";"1052";"1030"
"São José dos Ausentes (RS)";"Total";"Total";"3290";"1693";"1597"
"São Leopoldo (RS)";"Total";"Total";"214087";"104242";"109845"
"São Lourenço do Sul (RS)";"Total";"Total";"43111";"21623";"21488"
"São Luiz Gonzaga (RS)";"Total";"Total";"34556";"16827";"17729"
"São Marcos (RS)";"Total";"Total";"20103";"9859";"10244"
"São Martinho (RS)";"Total";"Total";"5773";"2838";"2935"
"São Martinho da Serra (RS)";"Total";"Total";"3201";"1647";"1554"
"São Miguel das Missões (RS)";"Total";"Total";"7421";"3880";"3541"
"São Nicolau (RS)";"Total";"Total";"5727";"2906";"2821"
"São Paulo das Missões (RS)";"Total";"Total";"6364";"3228";"3136"
"São Pedro da Serra (RS)";"Total";"Total";"3315";"1683";"1632"
"São Pedro das Missões (RS)";"Total";"Total";"1886";"932";"954"
"São Pedro do Butiá (RS)";"Total";"Total";"2873";"1456";"1417"
"São Pedro do Sul (RS)";"Total";"Total";"16368";"8050";"8318"
"São Sebastião do Caí (RS)";"Total";"Total";"21932";"10738";"11194"
"São Sepé (RS)";"Total";"Total";"23798";"11777";"12021"
"São Valentim (RS)";"Total";"Total";"3632";"1811";"1821"
"São Valentim do Sul (RS)";"Total";"Total";"2168";"1112";"1056"
"São Valério do Sul (RS)";"Total";"Total";"2647";"1375";"1272"
"São Vendelino (RS)";"Total";"Total";"1944";"994";"950"
"São Vicente do Sul (RS)";"Total";"Total";"8440";"4206";"4234"
"Sapiranga (RS)";"Total";"Total";"74985";"36989";"37996"
"Sapucaia do Sul (RS)";"Total";"Total";"130957";"63747";"67210"
"Sarandi (RS)";"Total";"Total";"21285";"10269";"11016"
"Seberi (RS)";"Total";"Total";"10897";"5349";"5548"
"Sede Nova (RS)";"Total";"Total";"3011";"1531";"1480"
"Segredo (RS)";"Total";"Total";"7158";"3698";"3460"
"Selbach (RS)";"Total";"Total";"4929";"2403";"2526"
"Senador Salgado Filho (RS)";"Total";"Total";"2814";"1407";"1407"
"Sentinela do Sul (RS)";"Total";"Total";"5198";"2666";"2532"
"Serafina Corrêa (RS)";"Total";"Total";"14253";"7099";"7154"
"Sério (RS)";"Total";"Total";"2281";"1190";"1091"
"Sertão (RS)";"Total";"Total";"6294";"3045";"3249"
"Sertão Santana (RS)";"Total";"Total";"5850";"2934";"2916"
"Sete de Setembro (RS)";"Total";"Total";"2124";"1082";"1042"
"Severiano de Almeida (RS)";"Total";"Total";"3842";"1942";"1900"
"Silveira Martins (RS)";"Total";"Total";"2449";"1227";"1222"
"Sinimbu (RS)";"Total";"Total";"10068";"5217";"4851"
"Sobradinho (RS)";"Total";"Total";"14283";"6992";"7291"
"Soledade (RS)";"Total";"Total";"30044";"14729";"15315"
"Tabaí (RS)";"Total";"Total";"4131";"2102";"2029"
"Tapejara (RS)";"Total";"Total";"19250";"9392";"9858"
"Tapera (RS)";"Total";"Total";"10448";"5093";"5355"
"Tapes (RS)";"Total";"Total";"16629";"8167";"8462"
"Taquara (RS)";"Total";"Total";"54643";"26866";"27777"
"Taquari (RS)";"Total";"Total";"26092";"12689";"13403"
"Taquaruçu do Sul (RS)";"Total";"Total";"2966";"1517";"1449"
"Tavares (RS)";"Total";"Total";"5351";"2777";"2574"
"Tenente Portela (RS)";"Total";"Total";"13719";"6713";"7006"
"Terra de Areia (RS)";"Total";"Total";"9878";"4959";"4919"
"Teutônia (RS)";"Total";"Total";"27272";"13523";"13749"
"Tio Hugo (RS)";"Total";"Total";"2724";"1372";"1352"
"Tiradentes do Sul (RS)";"Total";"Total";"6461";"3268";"3193"
"Toropi (RS)";"Total";"Total";"2952";"1561";"1391"
"Torres (RS)";"Total";"Total";"34656";"16835";"17821"
"Tramandaí (RS)";"Total";"Total";"41585";"20095";"21490"
"Travesseiro (RS)";"Total";"Total";"2314";"1171";"1143"
"Três Arroios (RS)";"Total";"Total";"2855";"1428";"1427"
"Três Cachoeiras (RS)";"Total";"Total";"10217";"5156";"5061"
"Três Coroas (RS)";"Total";"Total";"23848";"11837";"12011"
"Três de Maio (RS)";"Total";"Total";"23726";"11484";"12242"
"Três Forquilhas (RS)";"Total";"Total";"2914";"1512";"1402"
"Três Palmeiras (RS)";"Total";"Total";"4381";"2210";"2171"
"Três Passos (RS)";"Total";"Total";"23965";"11751";"12214"
"Trindade do Sul (RS)";"Total";"Total";"5787";"2884";"2903"
"Triunfo (RS)";"Total";"Total";"25793";"12933";"12860"
"Tucunduva (RS)";"Total";"Total";"5898";"2817";"3081"
"Tunas (RS)";"Total";"Total";"4395";"2278";"2117"
"Tupanci do Sul (RS)";"Total";"Total";"1573";"816";"757"
"Tupanciretã (RS)";"Total";"Total";"22281";"10864";"11417"
"Tupandi (RS)";"Total";"Total";"3924";"2068";"1856"
"Tuparendi (RS)";"Total";"Total";"8557";"4146";"4411"
"Turuçu (RS)";"Total";"Total";"3522";"1778";"1744"
"Ubiretama (RS)";"Total";"Total";"2296";"1183";"1113"
"União da Serra (RS)";"Total";"Total";"1487";"797";"690"
"Unistalda (RS)";"Total";"Total";"2450";"1245";"1205"
"Uruguaiana (RS)";"Total";"Total";"125435";"61009";"64426"
"Vacaria (RS)";"Total";"Total";"61342";"30083";"31259"
"Vale Verde (RS)";"Total";"Total";"3253";"1652";"1601"
"Vale do Sol (RS)";"Total";"Total";"11077";"5597";"5480"
"Vale Real (RS)";"Total";"Total";"5118";"2570";"2548"
"Vanini (RS)";"Total";"Total";"1984";"993";"991"
"Venâncio Aires (RS)";"Total";"Total";"65946";"32643";"33303"
"Vera Cruz (RS)";"Total";"Total";"23983";"11749";"12234"
"Veranópolis (RS)";"Total";"Total";"22810";"11102";"11708"
"Vespasiano Corrêa (RS)";"Total";"Total";"1974";"1024";"950"
"Viadutos (RS)";"Total";"Total";"5311";"2620";"2691"
"Viamão (RS)";"Total";"Total";"239384";"116483";"122901"
"Vicente Dutra (RS)";"Total";"Total";"5285";"2701";"2584"
"Victor Graeff (RS)";"Total";"Total";"3036";"1512";"1524"
"Vila Flores (RS)";"Total";"Total";"3207";"1617";"1590"
"Vila Lângaro (RS)";"Total";"Total";"2152";"1123";"1029"
"Vila Maria (RS)";"Total";"Total";"4221";"2116";"2105"
"Vila Nova do Sul (RS)";"Total";"Total";"4221";"2102";"2119"
"Vista Alegre (RS)";"Total";"Total";"2832";"1400";"1432"
"Vista Alegre do Prata (RS)";"Total";"Total";"1569";"819";"750"
"Vista Gaúcha (RS)";"Total";"Total";"2759";"1395";"1364"
"Vitória das Missões (RS)";"Total";"Total";"3485";"1794";"1691"
"Westfália (RS)";"Total";"Total";"2793";"1406";"1387"
"Xangri-lá (RS)";"Total";"Total";"12434";"6199";"6235"
"Água Clara (MS)";"Total";"Total";"14424";"7545";"6879"
"Alcinópolis (MS)";"Total";"Total";"4569";"2432";"2137"
"Amambai (MS)";"Total";"Total";"34730";"17375";"17355"
"Anastácio (MS)";"Total";"Total";"23835";"11911";"11924"
"Anaurilândia (MS)";"Total";"Total";"8493";"4313";"4180"
"Angélica (MS)";"Total";"Total";"9185";"4696";"4489"
"Antônio João (MS)";"Total";"Total";"8208";"4108";"4100"
"Aparecida do Taboado (MS)";"Total";"Total";"22320";"11152";"11168"
"Aquidauana (MS)";"Total";"Total";"45614";"22851";"22763"
"Aral Moreira (MS)";"Total";"Total";"10251";"5266";"4985"
"Bandeirantes (MS)";"Total";"Total";"6609";"3459";"3150"
"Bataguassu (MS)";"Total";"Total";"19839";"10090";"9749"
"Batayporã (MS)";"Total";"Total";"10936";"5419";"5517"
"Bela Vista (MS)";"Total";"Total";"23181";"11720";"11461"
"Bodoquena (MS)";"Total";"Total";"7985";"4113";"3872"
"Bonito (MS)";"Total";"Total";"19587";"9878";"9709"
"Brasilândia (MS)";"Total";"Total";"11826";"6045";"5781"
"Caarapó (MS)";"Total";"Total";"25767";"12918";"12849"
"Camapuã (MS)";"Total";"Total";"13625";"7067";"6558"
"Campo Grande (MS)";"Total";"Total";"786797";"381333";"405464"
"Caracol (MS)";"Total";"Total";"5398";"2764";"2634"
"Cassilândia (MS)";"Total";"Total";"20966";"10464";"10502"
"Chapadão do Sul (MS)";"Total";"Total";"19648";"10277";"9371"
"Corguinho (MS)";"Total";"Total";"4862";"2629";"2233"
"Coronel Sapucaia (MS)";"Total";"Total";"14064";"6953";"7111"
"Corumbá (MS)";"Total";"Total";"103703";"52285";"51418"
"Costa Rica (MS)";"Total";"Total";"19695";"10246";"9449"
"Coxim (MS)";"Total";"Total";"32159";"16141";"16018"
"Deodápolis (MS)";"Total";"Total";"12139";"6127";"6012"
"Dois Irmãos do Buriti (MS)";"Total";"Total";"10363";"5531";"4832"
"Douradina (MS)";"Total";"Total";"5364";"2722";"2642"
"Dourados (MS)";"Total";"Total";"196035";"96274";"99761"
"Eldorado (MS)";"Total";"Total";"11694";"5783";"5911"
"Fátima do Sul (MS)";"Total";"Total";"19035";"9363";"9672"
"Figueirão (MS)";"Total";"Total";"2928";"1553";"1375"
"Glória de Dourados (MS)";"Total";"Total";"9927";"4894";"5033"
"Guia Lopes da Laguna (MS)";"Total";"Total";"10366";"5208";"5158"
"Iguatemi (MS)";"Total";"Total";"14875";"7427";"7448"
"Inocência (MS)";"Total";"Total";"7669";"3964";"3705"
"Itaporã (MS)";"Total";"Total";"20865";"10407";"10458"
"Itaquiraí (MS)";"Total";"Total";"18614";"9712";"8902"
"Ivinhema (MS)";"Total";"Total";"22341";"11269";"11072"
"Japorã (MS)";"Total";"Total";"7731";"3908";"3823"
"Jaraguari (MS)";"Total";"Total";"6341";"3407";"2934"
"Jardim (MS)";"Total";"Total";"24346";"12130";"12216"
"Jateí (MS)";"Total";"Total";"4011";"2090";"1921"
"Juti (MS)";"Total";"Total";"5900";"3010";"2890"
"Ladário (MS)";"Total";"Total";"19617";"9829";"9788"
"Laguna Carapã (MS)";"Total";"Total";"6491";"3295";"3196"
"Maracaju (MS)";"Total";"Total";"37405";"19387";"18018"
"Miranda (MS)";"Total";"Total";"25595";"13221";"12374"
"Mundo Novo (MS)";"Total";"Total";"17043";"8260";"8783"
"Naviraí (MS)";"Total";"Total";"46424";"23226";"23198"
"Nioaque (MS)";"Total";"Total";"14391";"7547";"6844"
"Nova Alvorada do Sul (MS)";"Total";"Total";"16432";"8478";"7954"
"Nova Andradina (MS)";"Total";"Total";"45585";"22733";"22852"
"Novo Horizonte do Sul (MS)";"Total";"Total";"4940";"2513";"2427"
"Paranaíba (MS)";"Total";"Total";"40192";"19957";"20235"
"Paranhos (MS)";"Total";"Total";"12350";"6261";"6089"
"Pedro Gomes (MS)";"Total";"Total";"7967";"4149";"3818"
"Ponta Porã (MS)";"Total";"Total";"77872";"38492";"39380"
"Porto Murtinho (MS)";"Total";"Total";"15372";"8234";"7138"
"Ribas do Rio Pardo (MS)";"Total";"Total";"20946";"10982";"9964"
"Rio Brilhante (MS)";"Total";"Total";"30663";"15711";"14952"
"Rio Negro (MS)";"Total";"Total";"5036";"2604";"2432"
"Rio Verde de Mato Grosso (MS)";"Total";"Total";"18890";"9486";"9404"
"Rochedo (MS)";"Total";"Total";"4928";"2573";"2355"
"Santa Rita do Pardo (MS)";"Total";"Total";"7259";"3805";"3454"
"São Gabriel do Oeste (MS)";"Total";"Total";"22203";"11200";"11003"
"Sete Quedas (MS)";"Total";"Total";"10780";"5481";"5299"
"Selvíria (MS)";"Total";"Total";"6287";"3215";"3072"
"Sidrolândia (MS)";"Total";"Total";"42132";"21515";"20617"
"Sonora (MS)";"Total";"Total";"14833";"7836";"6997"
"Tacuru (MS)";"Total";"Total";"10215";"5274";"4941"
"Taquarussu (MS)";"Total";"Total";"3518";"1807";"1711"
"Terenos (MS)";"Total";"Total";"17146";"9146";"8000"
"Três Lagoas (MS)";"Total";"Total";"101791";"50523";"51268"
"Vicentina (MS)";"Total";"Total";"5901";"2959";"2942"
"Acorizal (MT)";"Total";"Total";"5516";"2900";"2616"
"Água Boa (MT)";"Total";"Total";"20856";"10932";"9924"
"Alta Floresta (MT)";"Total";"Total";"49164";"24989";"24175"
"Alto Araguaia (MT)";"Total";"Total";"15644";"8011";"7633"
"Alto Boa Vista (MT)";"Total";"Total";"5247";"2732";"2515"
"Alto Garças (MT)";"Total";"Total";"10350";"5438";"4912"
"Alto Paraguai (MT)";"Total";"Total";"10066";"5413";"4653"
"Alto Taquari (MT)";"Total";"Total";"8072";"4277";"3795"
"Apiacás (MT)";"Total";"Total";"8567";"4663";"3904"
"Araguaiana (MT)";"Total";"Total";"3197";"1637";"1560"
"Araguainha (MT)";"Total";"Total";"1096";"585";"511"
"Araputanga (MT)";"Total";"Total";"15342";"7583";"7759"
"Arenápolis (MT)";"Total";"Total";"10316";"5191";"5125"
"Aripuanã (MT)";"Total";"Total";"18656";"10077";"8579"
"Barão de Melgaço (MT)";"Total";"Total";"7591";"4134";"3457"
"Barra do Bugres (MT)";"Total";"Total";"31793";"16551";"15242"
"Barra do Garças (MT)";"Total";"Total";"56560";"28178";"28382"
"Bom Jesus do Araguaia (MT)";"Total";"Total";"5314";"2856";"2458"
"Brasnorte (MT)";"Total";"Total";"15357";"8285";"7072"
"Cáceres (MT)";"Total";"Total";"87942";"44098";"43844"
"Campinápolis (MT)";"Total";"Total";"14305";"7406";"6899"
"Campo Novo do Parecis (MT)";"Total";"Total";"27577";"14502";"13075"
"Campo Verde (MT)";"Total";"Total";"31589";"16282";"15307"
"Campos de Júlio (MT)";"Total";"Total";"5154";"2665";"2489"
"Canabrava do Norte (MT)";"Total";"Total";"4786";"2549";"2237"
"Canarana (MT)";"Total";"Total";"18754";"9650";"9104"
"Carlinda (MT)";"Total";"Total";"10990";"5817";"5173"
"Castanheira (MT)";"Total";"Total";"8231";"4345";"3886"
"Chapada dos Guimarães (MT)";"Total";"Total";"17821";"9294";"8527"
"Cláudia (MT)";"Total";"Total";"11028";"5728";"5300"
"Cocalinho (MT)";"Total";"Total";"5490";"2897";"2593"
"Colíder (MT)";"Total";"Total";"30766";"15552";"15214"
"Colniza (MT)";"Total";"Total";"26381";"14084";"12297"
"Comodoro (MT)";"Total";"Total";"18178";"9376";"8802"
"Confresa (MT)";"Total";"Total";"25124";"13347";"11777"
"Conquista D'Oeste (MT)";"Total";"Total";"3385";"1788";"1597"
"Cotriguaçu (MT)";"Total";"Total";"14983";"7977";"7006"
"Cuiabá (MT)";"Total";"Total";"551098";"269204";"281894"
"Curvelândia (MT)";"Total";"Total";"4866";"2534";"2332"
"Denise (MT)";"Total";"Total";"8523";"4393";"4130"
"Diamantino (MT)";"Total";"Total";"20341";"10512";"9829"
"Dom Aquino (MT)";"Total";"Total";"8171";"4222";"3949"
"Feliz Natal (MT)";"Total";"Total";"10933";"5580";"5353"
"Figueirópolis D'Oeste (MT)";"Total";"Total";"3796";"1936";"1860"
"Gaúcha do Norte (MT)";"Total";"Total";"6293";"3443";"2850"
"General Carneiro (MT)";"Total";"Total";"5027";"2644";"2383"
"Glória D'Oeste (MT)";"Total";"Total";"3135";"1595";"1540"
"Guarantã do Norte (MT)";"Total";"Total";"32216";"16511";"15705"
"Guiratinga (MT)";"Total";"Total";"13934";"7287";"6647"
"Indiavaí (MT)";"Total";"Total";"2397";"1249";"1148"
"Ipiranga do Norte (MT)";"Total";"Total";"5123";"2795";"2328"
"Itanhangá (MT)";"Total";"Total";"5276";"2881";"2395"
"Itaúba (MT)";"Total";"Total";"4575";"2398";"2177"
"Itiquira (MT)";"Total";"Total";"11478";"6225";"5253"
"Jaciara (MT)";"Total";"Total";"25647";"12981";"12666"
"Jangada (MT)";"Total";"Total";"7696";"3963";"3733"
"Jauru (MT)";"Total";"Total";"10455";"5259";"5196"
"Juara (MT)";"Total";"Total";"32791";"16956";"15835"
"Juína (MT)";"Total";"Total";"39255";"20136";"19119"
"Juruena (MT)";"Total";"Total";"11201";"5808";"5393"
"Juscimeira (MT)";"Total";"Total";"11430";"5960";"5470"
"Lambari D'Oeste (MT)";"Total";"Total";"5431";"2852";"2579"
"Lucas do Rio Verde (MT)";"Total";"Total";"45556";"24016";"21540"
"Luciara (MT)";"Total";"Total";"2224";"1146";"1078"
"Vila Bela da Santíssima Trindade (MT)";"Total";"Total";"14493";"7565";"6928"
"Marcelândia (MT)";"Total";"Total";"12006";"6368";"5638"
"Matupá (MT)";"Total";"Total";"14174";"7357";"6817"
"Mirassol d'Oeste (MT)";"Total";"Total";"25299";"12685";"12614"
"Nobres (MT)";"Total";"Total";"15002";"7830";"7172"
"Nortelândia (MT)";"Total";"Total";"6436";"3310";"3126"
"Nossa Senhora do Livramento (MT)";"Total";"Total";"11609";"6270";"5339"
"Nova Bandeirantes (MT)";"Total";"Total";"11643";"6378";"5265"
"Nova Nazaré (MT)";"Total";"Total";"3029";"1565";"1464"
"Nova Lacerda (MT)";"Total";"Total";"5436";"2916";"2520"
"Nova Santa Helena (MT)";"Total";"Total";"3468";"1811";"1657"
"Nova Brasilândia (MT)";"Total";"Total";"4587";"2401";"2186"
"Nova Canaã do Norte (MT)";"Total";"Total";"12127";"6453";"5674"
"Nova Mutum (MT)";"Total";"Total";"31649";"16799";"14850"
"Nova Olímpia (MT)";"Total";"Total";"17515";"9056";"8459"
"Nova Ubiratã (MT)";"Total";"Total";"9218";"5132";"4086"
"Nova Xavantina (MT)";"Total";"Total";"19643";"10028";"9615"
"Novo Mundo (MT)";"Total";"Total";"7332";"3916";"3416"
"Novo Horizonte do Norte (MT)";"Total";"Total";"3749";"1936";"1813"
"Novo São Joaquim (MT)";"Total";"Total";"6042";"3141";"2901"
"Paranaíta (MT)";"Total";"Total";"10684";"5741";"4943"
"Paranatinga (MT)";"Total";"Total";"19290";"10310";"8980"
"Novo Santo Antônio (MT)";"Total";"Total";"2005";"1105";"900"
"Pedra Preta (MT)";"Total";"Total";"15755";"8115";"7640"
"Peixoto de Azevedo (MT)";"Total";"Total";"30812";"15970";"14842"
"Planalto da Serra (MT)";"Total";"Total";"2726";"1400";"1326"
"Poconé (MT)";"Total";"Total";"31779";"16519";"15260"
"Pontal do Araguaia (MT)";"Total";"Total";"5395";"2776";"2619"
"Ponte Branca (MT)";"Total";"Total";"1768";"919";"849"
"Pontes e Lacerda (MT)";"Total";"Total";"41408";"20922";"20486"
"Porto Alegre do Norte (MT)";"Total";"Total";"10748";"5737";"5011"
"Porto dos Gaúchos (MT)";"Total";"Total";"5449";"2860";"2589"
"Porto Esperidião (MT)";"Total";"Total";"11031";"5899";"5132"
"Porto Estrela (MT)";"Total";"Total";"3649";"1903";"1746"
"Poxoréu (MT)";"Total";"Total";"17599";"9258";"8341"
"Primavera do Leste (MT)";"Total";"Total";"52066";"26487";"25579"
"Querência (MT)";"Total";"Total";"13033";"6924";"6109"
"São José dos Quatro Marcos (MT)";"Total";"Total";"18998";"9501";"9497"
"Reserva do Cabaçal (MT)";"Total";"Total";"2572";"1322";"1250"
"Ribeirão Cascalheira (MT)";"Total";"Total";"8881";"4608";"4273"
"Ribeirãozinho (MT)";"Total";"Total";"2199";"1126";"1073"
"Rio Branco (MT)";"Total";"Total";"5070";"2537";"2533"
"Santa Carmem (MT)";"Total";"Total";"4085";"2147";"1938"
"Santo Afonso (MT)";"Total";"Total";"2991";"1628";"1363"
"São José do Povo (MT)";"Total";"Total";"3592";"1926";"1666"
"São José do Rio Claro (MT)";"Total";"Total";"17124";"9185";"7939"
"São José do Xingu (MT)";"Total";"Total";"5240";"2824";"2416"
"São Pedro da Cipa (MT)";"Total";"Total";"4158";"2149";"2009"
"Rondolândia (MT)";"Total";"Total";"3604";"1902";"1702"
"Rondonópolis (MT)";"Total";"Total";"195476";"98197";"97279"
"Rosário Oeste (MT)";"Total";"Total";"17679";"9415";"8264"
"Santa Cruz do Xingu (MT)";"Total";"Total";"1900";"1046";"854"
"Salto do Céu (MT)";"Total";"Total";"3908";"2017";"1891"
"Santa Rita do Trivelato (MT)";"Total";"Total";"2491";"1362";"1129"
"Santa Terezinha (MT)";"Total";"Total";"7397";"3938";"3459"
"Santo Antônio do Leste (MT)";"Total";"Total";"3754";"2025";"1729"
"Santo Antônio do Leverger (MT)";"Total";"Total";"18463";"9861";"8602"
"São Félix do Araguaia (MT)";"Total";"Total";"10625";"5562";"5063"
"Sapezal (MT)";"Total";"Total";"18094";"9776";"8318"
"Serra Nova Dourada (MT)";"Total";"Total";"1365";"743";"622"
"Sinop (MT)";"Total";"Total";"113099";"57565";"55534"
"Sorriso (MT)";"Total";"Total";"66521";"34267";"32254"
"Tabaporã (MT)";"Total";"Total";"9932";"5308";"4624"
"Tangará da Serra (MT)";"Total";"Total";"83431";"41990";"41441"
"Tapurah (MT)";"Total";"Total";"10392";"6059";"4333"
"Terra Nova do Norte (MT)";"Total";"Total";"11291";"5884";"5407"
"Tesouro (MT)";"Total";"Total";"3418";"1903";"1515"
"Torixoréu (MT)";"Total";"Total";"4071";"2120";"1951"
"União do Sul (MT)";"Total";"Total";"3760";"2044";"1716"
"Vale de São Domingos (MT)";"Total";"Total";"3052";"1643";"1409"
"Várzea Grande (MT)";"Total";"Total";"252596";"125267";"127329"
"Vera (MT)";"Total";"Total";"10235";"5304";"4931"
"Vila Rica (MT)";"Total";"Total";"21382";"11188";"10194"
"Nova Guarita (MT)";"Total";"Total";"4932";"2582";"2350"
"Nova Marilândia (MT)";"Total";"Total";"2951";"1591";"1360"
"Nova Maringá (MT)";"Total";"Total";"6590";"3599";"2991"
"Nova Monte Verde (MT)";"Total";"Total";"8093";"4388";"3705"
"Abadia de Goiás (GO)";"Total";"Total";"6876";"3371";"3505"
"Abadiânia (GO)";"Total";"Total";"15757";"8089";"7668"
"Acreúna (GO)";"Total";"Total";"20279";"10379";"9900"
"Adelândia (GO)";"Total";"Total";"2477";"1273";"1204"
"Água Fria de Goiás (GO)";"Total";"Total";"5090";"2731";"2359"
"Água Limpa (GO)";"Total";"Total";"2013";"1048";"965"
"Águas Lindas de Goiás (GO)";"Total";"Total";"159378";"79726";"79652"
"Alexânia (GO)";"Total";"Total";"23814";"12010";"11804"
"Aloândia (GO)";"Total";"Total";"2051";"1048";"1003"
"Alto Horizonte (GO)";"Total";"Total";"4505";"2351";"2154"
"Alto Paraíso de Goiás (GO)";"Total";"Total";"6885";"3408";"3477"
"Alvorada do Norte (GO)";"Total";"Total";"8084";"4108";"3976"
"Amaralina (GO)";"Total";"Total";"3434";"1833";"1601"
"Americano do Brasil (GO)";"Total";"Total";"5508";"2858";"2650"
"Amorinópolis (GO)";"Total";"Total";"3609";"1830";"1779"
"Anápolis (GO)";"Total";"Total";"334613";"163256";"171357"
"Anhanguera (GO)";"Total";"Total";"1020";"516";"504"
"Anicuns (GO)";"Total";"Total";"20239";"10407";"9832"
"Aparecida de Goiânia (GO)";"Total";"Total";"455657";"224798";"230859"
"Aparecida do Rio Doce (GO)";"Total";"Total";"2427";"1241";"1186"
"Aporé (GO)";"Total";"Total";"3803";"2005";"1798"
"Araçu (GO)";"Total";"Total";"3802";"1909";"1893"
"Aragarças (GO)";"Total";"Total";"18305";"9186";"9119"
"Aragoiânia (GO)";"Total";"Total";"8365";"4265";"4100"
"Araguapaz (GO)";"Total";"Total";"7510";"3851";"3659"
"Arenópolis (GO)";"Total";"Total";"3277";"1676";"1601"
"Aruanã (GO)";"Total";"Total";"7496";"3921";"3575"
"Aurilândia (GO)";"Total";"Total";"3650";"1839";"1811"
"Avelinópolis (GO)";"Total";"Total";"2450";"1234";"1216"
"Baliza (GO)";"Total";"Total";"3714";"2043";"1671"
"Barro Alto (GO)";"Total";"Total";"8716";"4509";"4207"
"Bela Vista de Goiás (GO)";"Total";"Total";"24554";"12612";"11942"
"Bom Jardim de Goiás (GO)";"Total";"Total";"8423";"4304";"4119"
"Bom Jesus de Goiás (GO)";"Total";"Total";"20727";"10757";"9970"
"Bonfinópolis (GO)";"Total";"Total";"7536";"3777";"3759"
"Bonópolis (GO)";"Total";"Total";"3503";"1834";"1669"
"Brazabrantes (GO)";"Total";"Total";"3232";"1646";"1586"
"Britânia (GO)";"Total";"Total";"5509";"2809";"2700"
"Buriti Alegre (GO)";"Total";"Total";"9054";"4535";"4519"
"Buriti de Goiás (GO)";"Total";"Total";"2560";"1321";"1239"
"Buritinópolis (GO)";"Total";"Total";"3321";"1703";"1618"
"Cabeceiras (GO)";"Total";"Total";"7354";"3778";"3576"
"Cachoeira Alta (GO)";"Total";"Total";"10553";"5749";"4804"
"Cachoeira de Goiás (GO)";"Total";"Total";"1417";"731";"686"
"Cachoeira Dourada (GO)";"Total";"Total";"8254";"4173";"4081"
"Caçu (GO)";"Total";"Total";"13283";"7031";"6252"
"Caiapônia (GO)";"Total";"Total";"16757";"8545";"8212"
"Caldas Novas (GO)";"Total";"Total";"70473";"35021";"35452"
"Caldazinha (GO)";"Total";"Total";"3325";"1689";"1636"
"Campestre de Goiás (GO)";"Total";"Total";"3387";"1772";"1615"
"Campinaçu (GO)";"Total";"Total";"3656";"1938";"1718"
"Campinorte (GO)";"Total";"Total";"11111";"5701";"5410"
"Campo Alegre de Goiás (GO)";"Total";"Total";"6060";"3108";"2952"
"Campo Limpo de Goiás (GO)";"Total";"Total";"6241";"3185";"3056"
"Campos Belos (GO)";"Total";"Total";"18410";"9125";"9285"
"Campos Verdes (GO)";"Total";"Total";"5020";"2571";"2449"
"Carmo do Rio Verde (GO)";"Total";"Total";"8928";"4547";"4381"
"Castelândia (GO)";"Total";"Total";"3638";"1918";"1720"
"Catalão (GO)";"Total";"Total";"86647";"43536";"43111"
"Caturaí (GO)";"Total";"Total";"4686";"2398";"2288"
"Cavalcante (GO)";"Total";"Total";"9392";"4915";"4477"
"Ceres (GO)";"Total";"Total";"20722";"10144";"10578"
"Cezarina (GO)";"Total";"Total";"7545";"3871";"3674"
"Chapadão do Céu (GO)";"Total";"Total";"7001";"3664";"3337"
"Cidade Ocidental (GO)";"Total";"Total";"55915";"27430";"28485"
"Cocalzinho de Goiás (GO)";"Total";"Total";"17407";"8952";"8455"
"Colinas do Sul (GO)";"Total";"Total";"3523";"1838";"1685"
"Córrego do Ouro (GO)";"Total";"Total";"2632";"1338";"1294"
"Corumbá de Goiás (GO)";"Total";"Total";"10361";"5415";"4946"
"Corumbaíba (GO)";"Total";"Total";"8181";"4284";"3897"
"Cristalina (GO)";"Total";"Total";"46580";"23977";"22603"
"Cristianópolis (GO)";"Total";"Total";"2932";"1503";"1429"
"Crixás (GO)";"Total";"Total";"15760";"8254";"7506"
"Cromínia (GO)";"Total";"Total";"3555";"1794";"1761"
"Cumari (GO)";"Total";"Total";"2964";"1515";"1449"
"Damianópolis (GO)";"Total";"Total";"3292";"1709";"1583"
"Damolândia (GO)";"Total";"Total";"2747";"1383";"1364"
"Davinópolis (GO)";"Total";"Total";"2056";"1082";"974"
"Diorama (GO)";"Total";"Total";"2479";"1262";"1217"
"Doverlândia (GO)";"Total";"Total";"7892";"4162";"3730"
"Edealina (GO)";"Total";"Total";"3733";"1930";"1803"
"Edéia (GO)";"Total";"Total";"11266";"5779";"5487"
"Estrela do Norte (GO)";"Total";"Total";"3320";"1720";"1600"
"Faina (GO)";"Total";"Total";"6983";"3652";"3331"
"Fazenda Nova (GO)";"Total";"Total";"6322";"3248";"3074"
"Firminópolis (GO)";"Total";"Total";"11580";"5701";"5879"
"Flores de Goiás (GO)";"Total";"Total";"12066";"6657";"5409"
"Formosa (GO)";"Total";"Total";"100085";"49959";"50126"
"Formoso (GO)";"Total";"Total";"4883";"2474";"2409"
"Gameleira de Goiás (GO)";"Total";"Total";"3275";"1724";"1551"
"Divinópolis de Goiás (GO)";"Total";"Total";"4962";"2595";"2367"
"Goianápolis (GO)";"Total";"Total";"10695";"5453";"5242"
"Goiandira (GO)";"Total";"Total";"5265";"2633";"2632"
"Goianésia (GO)";"Total";"Total";"59549";"30075";"29474"
"Goiânia (GO)";"Total";"Total";"1302001";"620857";"681144"
"Goianira (GO)";"Total";"Total";"34060";"17120";"16940"
"Goiás (GO)";"Total";"Total";"24727";"12256";"12471"
"Goiatuba (GO)";"Total";"Total";"32492";"16219";"16273"
"Gouvelândia (GO)";"Total";"Total";"4949";"2569";"2380"
"Guapó (GO)";"Total";"Total";"13976";"6970";"7006"
"Guaraíta (GO)";"Total";"Total";"2376";"1187";"1189"
"Guarani de Goiás (GO)";"Total";"Total";"4258";"2291";"1967"
"Guarinos (GO)";"Total";"Total";"2299";"1225";"1074"
"Heitoraí (GO)";"Total";"Total";"3571";"1830";"1741"
"Hidrolândia (GO)";"Total";"Total";"17398";"8942";"8456"
"Hidrolina (GO)";"Total";"Total";"4029";"2043";"1986"
"Iaciara (GO)";"Total";"Total";"12427";"6379";"6048"
"Inaciolândia (GO)";"Total";"Total";"5699";"2917";"2782"
"Indiara (GO)";"Total";"Total";"13687";"7086";"6601"
"Inhumas (GO)";"Total";"Total";"48246";"23666";"24580"
"Ipameri (GO)";"Total";"Total";"24735";"12444";"12291"
"Ipiranga de Goiás (GO)";"Total";"Total";"2844";"1451";"1393"
"Iporá (GO)";"Total";"Total";"31274";"15302";"15972"
"Israelândia (GO)";"Total";"Total";"2887";"1463";"1424"
"Itaberaí (GO)";"Total";"Total";"35371";"17849";"17522"
"Itaguari (GO)";"Total";"Total";"4513";"2276";"2237"
"Itaguaru (GO)";"Total";"Total";"5437";"2742";"2695"
"Itajá (GO)";"Total";"Total";"5062";"2508";"2554"
"Itapaci (GO)";"Total";"Total";"18458";"9379";"9079"
"Itapirapuã (GO)";"Total";"Total";"7835";"3963";"3872"
"Itapuranga (GO)";"Total";"Total";"26125";"12922";"13203"
"Itarumã (GO)";"Total";"Total";"6300";"3318";"2982"
"Itauçu (GO)";"Total";"Total";"8575";"4235";"4340"
"Itumbiara (GO)";"Total";"Total";"92883";"45796";"47087"
"Ivolândia (GO)";"Total";"Total";"2663";"1405";"1258"
"Jandaia (GO)";"Total";"Total";"6164";"3175";"2989"
"Jaraguá (GO)";"Total";"Total";"41870";"21241";"20629"
"Jataí (GO)";"Total";"Total";"88006";"43961";"44045"
"Jaupaci (GO)";"Total";"Total";"3000";"1517";"1483"
"Jesúpolis (GO)";"Total";"Total";"2300";"1206";"1094"
"Joviânia (GO)";"Total";"Total";"7118";"3608";"3510"
"Jussara (GO)";"Total";"Total";"19153";"9587";"9566"
"Lagoa Santa (GO)";"Total";"Total";"1254";"643";"611"
"Leopoldo de Bulhões (GO)";"Total";"Total";"7882";"4013";"3869"
"Luziânia (GO)";"Total";"Total";"174531";"87087";"87444"
"Mairipotaba (GO)";"Total";"Total";"2374";"1238";"1136"
"Mambaí (GO)";"Total";"Total";"6871";"3529";"3342"
"Mara Rosa (GO)";"Total";"Total";"10649";"5426";"5223"
"Marzagão (GO)";"Total";"Total";"2072";"1026";"1046"
"Matrinchã (GO)";"Total";"Total";"4414";"2254";"2160"
"Maurilândia (GO)";"Total";"Total";"11521";"6022";"5499"
"Mimoso de Goiás (GO)";"Total";"Total";"2685";"1427";"1258"
"Minaçu (GO)";"Total";"Total";"31154";"15837";"15317"
"Mineiros (GO)";"Total";"Total";"52935";"27140";"25795"
"Moiporá (GO)";"Total";"Total";"1763";"899";"864"
"Monte Alegre de Goiás (GO)";"Total";"Total";"7730";"3994";"3736"
"Montes Claros de Goiás (GO)";"Total";"Total";"7987";"4094";"3893"
"Montividiu (GO)";"Total";"Total";"10572";"5499";"5073"
"Montividiu do Norte (GO)";"Total";"Total";"4122";"2109";"2013"
"Morrinhos (GO)";"Total";"Total";"41460";"20773";"20687"
"Morro Agudo de Goiás (GO)";"Total";"Total";"2356";"1173";"1183"
"Mossâmedes (GO)";"Total";"Total";"5007";"2557";"2450"
"Mozarlândia (GO)";"Total";"Total";"13404";"6843";"6561"
"Mundo Novo (GO)";"Total";"Total";"6438";"3428";"3010"
"Mutunópolis (GO)";"Total";"Total";"3849";"2003";"1846"
"Nazário (GO)";"Total";"Total";"7874";"3963";"3911"
"Nerópolis (GO)";"Total";"Total";"24210";"11923";"12287"
"Niquelândia (GO)";"Total";"Total";"42361";"21689";"20672"
"Nova América (GO)";"Total";"Total";"2259";"1158";"1101"
"Nova Aurora (GO)";"Total";"Total";"2062";"1074";"988"
"Nova Crixás (GO)";"Total";"Total";"11927";"6223";"5704"
"Nova Glória (GO)";"Total";"Total";"8508";"4246";"4262"
"Nova Iguaçu de Goiás (GO)";"Total";"Total";"2826";"1455";"1371"
"Nova Roma (GO)";"Total";"Total";"3471";"1794";"1677"
"Nova Veneza (GO)";"Total";"Total";"8129";"4128";"4001"
"Novo Brasil (GO)";"Total";"Total";"3519";"1819";"1700"
"Novo Gama (GO)";"Total";"Total";"95018";"46672";"48346"
"Novo Planalto (GO)";"Total";"Total";"3956";"2072";"1884"
"Orizona (GO)";"Total";"Total";"14300";"7389";"6911"
"Ouro Verde de Goiás (GO)";"Total";"Total";"4034";"2008";"2026"
"Ouvidor (GO)";"Total";"Total";"5467";"2811";"2656"
"Padre Bernardo (GO)";"Total";"Total";"27671";"13992";"13679"
"Palestina de Goiás (GO)";"Total";"Total";"3371";"1776";"1595"
"Palmeiras de Goiás (GO)";"Total";"Total";"23338";"11819";"11519"
"Palmelo (GO)";"Total";"Total";"2335";"1149";"1186"
"Palminópolis (GO)";"Total";"Total";"3557";"1779";"1778"
"Panamá (GO)";"Total";"Total";"2682";"1370";"1312"
"Paranaiguara (GO)";"Total";"Total";"9100";"4588";"4512"
"Paraúna (GO)";"Total";"Total";"10863";"5521";"5342"
"Perolândia (GO)";"Total";"Total";"2950";"1570";"1380"
"Petrolina de Goiás (GO)";"Total";"Total";"10283";"5368";"4915"
"Pilar de Goiás (GO)";"Total";"Total";"2773";"1467";"1306"
"Piracanjuba (GO)";"Total";"Total";"24026";"12194";"11832"
"Piranhas (GO)";"Total";"Total";"11266";"5718";"5548"
"Pirenópolis (GO)";"Total";"Total";"23006";"11797";"11209"
"Pires do Rio (GO)";"Total";"Total";"28762";"14105";"14657"
"Planaltina (GO)";"Total";"Total";"81649";"40574";"41075"
"Pontalina (GO)";"Total";"Total";"17121";"8578";"8543"
"Porangatu (GO)";"Total";"Total";"42355";"21285";"21070"
"Porteirão (GO)";"Total";"Total";"3347";"1808";"1539"
"Portelândia (GO)";"Total";"Total";"3839";"1986";"1853"
"Posse (GO)";"Total";"Total";"31419";"15925";"15494"
"Professor Jamil (GO)";"Total";"Total";"3239";"1676";"1563"
"Quirinópolis (GO)";"Total";"Total";"43220";"21934";"21286"
"Rialma (GO)";"Total";"Total";"10523";"5239";"5284"
"Rianápolis (GO)";"Total";"Total";"4566";"2319";"2247"
"Rio Quente (GO)";"Total";"Total";"3312";"1733";"1579"
"Rio Verde (GO)";"Total";"Total";"176424";"90030";"86394"
"Rubiataba (GO)";"Total";"Total";"18915";"9429";"9486"
"Sanclerlândia (GO)";"Total";"Total";"7550";"3843";"3707"
"Santa Bárbara de Goiás (GO)";"Total";"Total";"5751";"2932";"2819"
"Santa Cruz de Goiás (GO)";"Total";"Total";"3142";"1645";"1497"
"Santa Fé de Goiás (GO)";"Total";"Total";"4762";"2405";"2357"
"Santa Helena de Goiás (GO)";"Total";"Total";"36469";"18317";"18152"
"Santa Isabel (GO)";"Total";"Total";"3686";"1906";"1780"
"Santa Rita do Araguaia (GO)";"Total";"Total";"6924";"3545";"3379"
"Santa Rita do Novo Destino (GO)";"Total";"Total";"3173";"1727";"1446"
"Santa Rosa de Goiás (GO)";"Total";"Total";"2909";"1452";"1457"
"Santa Tereza de Goiás (GO)";"Total";"Total";"3995";"1994";"2001"
"Santa Terezinha de Goiás (GO)";"Total";"Total";"10302";"5261";"5041"
"Santo Antônio da Barra (GO)";"Total";"Total";"4423";"2346";"2077"
"Santo Antônio de Goiás (GO)";"Total";"Total";"4703";"2389";"2314"
"Santo Antônio do Descoberto (GO)";"Total";"Total";"63248";"31371";"31877"
"São Domingos (GO)";"Total";"Total";"11272";"5928";"5344"
"São Francisco de Goiás (GO)";"Total";"Total";"6120";"3147";"2973"
"São João d'Aliança (GO)";"Total";"Total";"10257";"5274";"4983"
"São João da Paraúna (GO)";"Total";"Total";"1689";"843";"846"
"São Luís de Montes Belos (GO)";"Total";"Total";"30034";"14731";"15303"
"São Luiz do Norte (GO)";"Total";"Total";"4617";"2334";"2283"
"São Miguel do Araguaia (GO)";"Total";"Total";"22283";"11391";"10892"
"São Miguel do Passa Quatro (GO)";"Total";"Total";"3757";"1944";"1813"
"São Patrício (GO)";"Total";"Total";"1991";"1000";"991"
"São Simão (GO)";"Total";"Total";"17088";"8866";"8222"
"Senador Canedo (GO)";"Total";"Total";"84443";"42211";"42232"
"Serranópolis (GO)";"Total";"Total";"7481";"3970";"3511"
"Silvânia (GO)";"Total";"Total";"19089";"9807";"9282"
"Simolândia (GO)";"Total";"Total";"6514";"3303";"3211"
"Sítio d'Abadia (GO)";"Total";"Total";"2825";"1519";"1306"
"Taquaral de Goiás (GO)";"Total";"Total";"3541";"1766";"1775"
"Teresina de Goiás (GO)";"Total";"Total";"3016";"1542";"1474"
"Terezópolis de Goiás (GO)";"Total";"Total";"6561";"3346";"3215"
"Três Ranchos (GO)";"Total";"Total";"2819";"1424";"1395"
"Trindade (GO)";"Total";"Total";"104488";"51445";"53043"
"Trombas (GO)";"Total";"Total";"3452";"1784";"1668"
"Turvânia (GO)";"Total";"Total";"4839";"2431";"2408"
"Turvelândia (GO)";"Total";"Total";"4399";"2338";"2061"
"Uirapuru (GO)";"Total";"Total";"2933";"1525";"1408"
"Uruaçu (GO)";"Total";"Total";"36929";"18437";"18492"
"Uruana (GO)";"Total";"Total";"13826";"7006";"6820"
"Urutaí (GO)";"Total";"Total";"3074";"1562";"1512"
"Valparaíso de Goiás (GO)";"Total";"Total";"132982";"64624";"68358"
"Varjão (GO)";"Total";"Total";"3659";"1852";"1807"
"Vianópolis (GO)";"Total";"Total";"12548";"6297";"6251"
"Vicentinópolis (GO)";"Total";"Total";"7371";"3873";"3498"
"Vila Boa (GO)";"Total";"Total";"4735";"2588";"2147"
"Vila Propício (GO)";"Total";"Total";"5145";"2689";"2456"
"Brasília (DF)";"Total";"Total";"2570160";"1228880";"1341280"